    B  BB               B B B B      B      B          B    B B     B   B B       BB BB B       B    
   BB   BBB   B BB    B B   B          B        B B   BB   B  B BB   B B    B  B  BB    B   B   B    
   B  BBB        B    BB   B      B            B     B B B     B        B     B    B   B  B   B     B
    B B  B B        BB B B  B   BB   B BB B       B  B           BB      B    B        B  BB       B 
     B B          B     B B       B   BBB  B B            BB  B B B BBBBB          B      B B      B 
 B            B    B     B  B   B    B B    B     BB        BBB    B B     B     BB B   B       B  B 
 B  B  BB    B      B B        B  B B  B  B       BB       BB    BB                B  B B  BB    B   
 BB     B      B        B  B       B  B B           BB       B   B                B   B B      B  B B
    BB      BBBB BB            B         B   B          B             B B        B                  B
 BB   B      B       BB  B   B       B      B   B            B              BB               BB B    
 B  B   B    B    B      B    B B     B          B      B    B       B  B B         B  B B         B 
     B  B               B  BBB B B            B        B   B    B          B     BB        B   B     
           BB B   B      B        B   BB     B    B  B    B B     B    B  B  B       B             B 
       B         B    B   B    B  B             B  BB  B B  B  B      B B B    BB  B       B         
  B  BB                       B BBBB   B      BB    B   B    B      B  B  BBB       B           B  B 
       BBB           B   B          BB      BBB           B  B         B      B  B   B B       B     
    B    B B   B  B        B       B B   B B  B BB BBBB              B  B             B  B B        B
  B      B   B        B  BB  B       B      B       B      B      B  B  B   B       B  B          B  
     B                      B     B          B           B         B    B        B      B    B    B  
B      B  BB  BB     B                 B  B       B    B B  B   B     B B   B  BBB B  B  B          B
   BB          B   B  B  BB B           B   B  B  B         B      B  B  B   B    B    BBB       B  B
B B B    B  B BB       B          B      B        BB    B      B B   B   BB     B     B   B    BB    
 BB  B B     B  BB BBB B B      B      B B B       B           B            B B    BB    B  B B B B  
  B   BB     B   B         B            BB   B     B B          B   B  BB                B        BB 
B           BB          B B  B B B       B    B            B   B   BB B  BBBB    B BBB               
             B        B     B      B  B  B        B       B       B         B         B              
 B  BB  B   B   BB  B  BB B       B B      B B         B     BB   B   BB           B BB   B    B    B
 B  B            BBBBB                  B  B   B    B B B                       B    B   B   B     BB
BBB            B   B         BB       B     B    B         B B B   B       B        B B B       B BB 
BB       B B   B   B         B     B   B  B  B      B                   B          B  B  BB          
                      B      BB  B    B      B    B B   B B B   B B  BBB BB      B B       B   B     
       B    B     BB        B         B      B    B         B    B B BBB  B          BB   B     BB   
   B            B B B             B BB      B             B     B  B            BBB     B   B  B BB  
               B   B    B        B   B   B    B B     B            B     B  BB   B   B         BT    
         B   BBB              B           B B   B  BBB       B      B   B B B        B  B    B B     
  B B     B            BB   B          B   BBB   BB    B   B    B BB B  B    B BB     BB     B     B 
             B  BB B    B   B           B   B   B              BB B     B                            
       B              B B B B        BB      B  BB     B BB  B           BB   BB        B  B  B      
   B       B B   B         B   B BB      B      B  B  B          B                B  B              B
B    B    BBB   B  B    B             B  B               B    B    B    B        B         BB B      
       B    B  B    B B            BB        B   B          B         B      B  B  BBB               
  B          B             BBB  B    B  B  B B        B       B  BB  B   B      BBB       BB    B    
B  BB      B     BB   BB            B B      B       BBBB   B       B            B   BB  BB          
          B        B   B   B B B B      B    B  BB   BB  BB       B      B    BB          B          
BB  B       B           B B    B    B     BBB         B   B   B       BB   B   B  B    B    B      B 
  B                  B    B     B       BBB     BB B     B B    B              BB B  B B   B       B 
  B        B           B   B           B  B B  B  B     B  BB B B    BB B     B    B   B B   B     BB
B  B  B B B     B        BB   B BB    B  B   BBB  BB B    B                        B   B   BB    B   
 BB        B    B    B  BB B BB BB   B   B   B   B    B      B          B B B          B            B
B         BB  B       B        B B      B   BB         B BB    BB B B  B  B           B          B   
    BB B      B B   B  B        BB      B    B  B  BB    B  B           B    B      BB       B B     
  B     B              B   B  B  B       B  B     B    B B           B   B   BBBB   B  B            B
 B     B    B  B             B      B            B       BB   BB     B                               
   B   B  BB   B B   BBB              B  B  B     B     B B   B        BBB    B B   B        B       
 B   B  B B  B  B   B B   BB   B           B BBB BB B B   B        B        BB  B         BBB     B  
      B BB  B  B   B   BB         B       B          B  B B   B  B   BBB B      B   BB  B            
    B  B  B B           BB    B  B BBB    B        B          B          B   B B B  B  B       BB BBB
 B    B       B     B         B  B    B       B    B         B          BB       B B       B         
                           B   B  B    B              BB         BB B   B     B BB     B   B B B   B 
    B B B      B   B      B            B      B        B                     B B B      BB    BB     
        B          B B BBB  B       BB B  B       B           B  B  B       B  B BB              B   
  B     B  B   B      BBB     B     B BB   B    B B    B BBBB         B  BB BB  B   BB     B     BB  
      BBB  BB                 B           BB B B      B     BB    BB               B      BBBB       
B B  B  B           B  B        B    BB B    B          B   B         B  B    B   B B   B         B B
BB  B       B   B      B       B   BB       BBBB BB     B B BB           B     B  B          B B     
   B     B    B   B               B B   B B   B   B  B    BBB   B B       BB B   BB BB B            B
  B B BBB             B      B    BB B B  BBBB       B BB B B       BB B         B        B          
  B      B       B B BBB                 B     B    B B     B B  B    B             B      B      B  
        B  BB             B           BB     B BBB        B  B BB          B B  BB             B    B
    B   B B  B   B        B         B B   B  B  B    B    B  B               B  B  B      B   B    B 
 B       B  B    BB        B           B   B B   B   BB  B B      B   B               B  B B B     B 
        B B         BB B      B              B B                B  B B        B  B        B      B B 
BB    B  B         BB     B  B              B B  B    BB   BB   B B  B     B     B    B           B B
     B B  B  B     B            B  BB    BB B             B   B   B   B        B     B     B      B  
              B     B BB     B    BB   B  B  B            B  B       B BBB   BB          B        B B
B BB B           B B            B B  BBB B B     B                  BB           BB           B     B
B    B  BB             B  B      B BB BB     BB     B B     B   B    B B BB B    BB    B            B
    BB B    B  B   B  B          B     B         B    BB           B           B   B B       B     B 
  BB  B   B  BB             B      BB   B     B           B   BB B     BB      B B B          B      
   B B                   B B                 B   B           B B   B    B  B B   B  B  BB B B   B    
      B      BBB        BB        B  B     B B   BB             B      B                  B     B    
      BB        B  B  B       B  BBB  B BB     B         B    B B    B  B  B        B       B BBBBBB 
                   B        B    B B  B B B    B         B  B    B  B               B          B BB  
          B      B  B  BB       B B              BBB     B             B B      B   B      B       B 
     B     B B          B              B   B   B    B                     BB  B       B    B BB  B  B
B B      B         B           BB  B           B                      B  BB  B     BB B B       B    
          B    B             B    BB   B  BB    B         B  B B  B     B  B       B  B      BB      
BB       BB    B              B  B B   B   B            BB B    B BBBB         BB                    
  B    BB   B    B B  B            B    BB B  BB    B                 BB       B B    BB    B   B   B
     B        B B        BB    B BBB  B   B     B    B   B             B                     BBBB  BB
      B  BB             B     BB     B     BB         B   B B B     B  B        B  B  BB BB    B     
     B    B              B           B  B           BB B B  B  B BB      B    B B      B    B        
B        BB B  B BB      BB  B   B BB BB   B      B       BB          B  B   B  B B           BBB  B 
B      B BB                   B BB    BB       B B    B    BB    B  B   B  B            BB       B   
    A      BB   B   B       B      BB   B   B           B B  B   B     B B    B    B B     B    B B  
  BBB  B          B  B B    B   B B            BB B        B    B BB         B           B  BB   B B 
    BB  BB    B     B B B   BB            B BB             B  B      BB   B   B B   B      B  B B    
      B B            B                      BB           B                     B        B BBB   B   B
   B     B     B    B         B       B           BB B          BBB  B B    B      B      B   B B  B 
B   BB   BB  B   B   BB  B B   B   B   BB    B   B      B         BB BB       B                    B 
 B      B   B B         B          B   B BB  B      BB    B B   B        B        B BB BB        B   