 B      B B   B       BB  B B   B BB B BB  B    B        B BB   B            B  B B      B           
                B B           B BB     B         B                   B  B   B                   B    
   B     B    B                     B   BB          B       B      B  B                          B   
B     BB    B B                B   B  B     B     B                   BB       B             B       
                        B   B   B B    B   B        B       B BB     B  B      B  B    B  B     B    
         B BB BB      B   B BB             B             B      B              B         B   BB B    
B         B    B B B     BB       B   B   B B  BBBB       B B         BB   BB              BB        
 B B    B           B    B    B    B    B        B   BB                 B   B      B B      B     B  
   B   B    B B    B     B  BBB      B         B B     BB          BBB       B  B  BB  B  BB     B  B
 B  B   B B      B    B B     B                      B  B  B BB   B      B             B     BB B    
 B    B B   B      B   B  B      B  BB           BB    B     BB     B      B    B    B       BB  B   
BB  B  B        B B B        B    BBB  B B   BB B B   B         B        BB  B   B       B B  B  B   
       B    B     B      B        B     B             BB    B           B     B      B    B          
  B    BB B  B  B    BBBBBB  B        B    B    B         BBB          BB          BB  B    BB  B    
B       B           B B          B   BB   B     B B  B BBB      BB              B  B         B       
  BB B BB       B      B       BB  B       B        B B B          B    B   B B  BB    B  B         B
B    B B BBB          B           B               BBB                 BB   B               B  B      
          BBB      B  B  B        B  B  B  BB        B    B        B BB    B        B B B B     B   B
B    B  B B  B          B  BB B       B B    BB BB     B   B B    B        B    BB              B    
      BBB        B               B    BB   B        B     B B                B        B  B     B     
   B     B      B B B    B      B          B   BB        BB           B   BB       B B BB     B    B 
 B  B      B                B B  B    B  B    B B  BB   B                 B  BB B BBB B   B B        
B      B   B  BBB   BB  B B      B           B             B  B           B     BB     BB          B 
B     B   BBB   B  BB   B  B B B   B          B   B          B        BB   B      B        B     B   
 B            BB B   B  B    B  B B   BBB BB B     B B         B   BB   B  B      B   B B   B B B  BB
   B  BB            B       B                 B       BB         B    B     B    B                 B 
  B   B            B  B      B   B    B  B BB        B        B  B  B   BB B                BB       
   B       B                      BB   B   B   B B B             BB B   B B  BB        B B         B 
       B   B       BBB     B     B              BB BB B BB B  BBB    B  B   B       B       B        
      B   B     BB            B B B BB   B           B  B  B           BBB  B     B                  
 B   BB        B B       BB                     B  B     B  BB     B   B     B   B    B     BB   BB  
    B         B                B    B     BB BB B     BB       B B    B   B B      BB   B  B  B    B 
            B B  B           B      B      B       B                        B  B       B B        B  
 B                B  B         B   B                     B  BB B         BB B  B        B     B  B   
BB         BB   B    B      B       B  B       B B       B       B B  B       B            B  BB     
          BB    B B B           B                 BB    B          B      B               B        B 
          B    B      B   B  B   B     B    B  BB     B BB    BB B             B  B      BB   B    B 
  B      B       B B        B        B                  B   B        B           B       B   B  B B  
B BB          B       B B   B      B    BB           B    BB        BB  B  B  BBB     B B  BB        
BB    BB       B    BB           BB B      BB B    B  B     B   B   B           B              B  B B
       BB         B   B     B            B     B  B                     B B B      B             B   
       B     BB        B B                 B           BBB     B B     B      B   B       B       BB 
                B          B BB       B  B       B  B BB       B B B  B         B       B         B  
       B       B  B    BB   B           B         BB    B B          B B    B BBB       B B B B  B   
    B B                 B    BB B      B B BB       B B B   B B   B  BB     B                        
    B    B  B  B   BBB       BB     B           B    B    B    B    BB B     BB  B BB                
    B  B           B     B       B  B  B           B  B   B             B     BB         B    B     B
B       BB  B   BB B B    B     B B       B  B   B               B     B   B                         
    B B   B B  B B     BB        B  B    B    B   B         B       B    B    BBB    BB      B     B 
  B                        B          B     B   B              BB  B    B      B        BB           
 B     B   BB BBB      B B B B         B        B     B B       BB   B  B   BB     B     BB     B    
B   B  B  B              B   B B   B B B            B    B  B  B B     B                  BB    BB   
B  B B       B  B    BB   B     B         B  B  B B         BB  B       B       B                    
 B     B B B             B     B BB B     B               B B    B    B   BB BB  B B    B       B  B 
BB         B   B             B     B     B    BBB B  B  BB      BB    B  B      B      B      B  B   
    BB    BBB          BBB BB   B B       B  B BB      B        B          B             B       BB  
B  B    B       B  B    B        B  B      B  BB     B  B  B     BB        B    B                  B 
 B  B   B    B  B    B B    B        BB    B BB  BBB        B   B               BB      B B BB       
BB         B        B     B             B B   B    B B     B       B B B B BB    BBB      B   BB     
 B   B BB                 B           B  B BB  B B   B   BB      B     B         B            B     B
  B B              B B      B     B         B            BB   B       B          B      B   B   BB   
 B  B       B B   B  B  B  B   B       B   B B      B B         B       B  B            B   BB  T   B
   B   B       B B        B  B      B   B             BB         BB           BB   B      B BB       
 B   B BB               B   BBB   B    B         B      B                  B   B              B      
B   B      B        B     B       BB  B  B    BB     B    B  B   B      B              B   B     B B 
  B B              BB             B                  B  B   BBB B                B       B   B    B  
                                     B    B   B    B   B        B         B   BB B BB   BB B B BB    
          BBB     B     B           B B B  BB     B        BB   BBBB B   B BB              B     BB B
   B    B         B  BB B B B B BBB  B    B B     B     B B B          BB B  B       B      B      BB
   BB   BB    BB B  B   B   BB    B    B      BB   B  BB   B        B   B       B           B  B    B
         B B     B      BB B        B     B              B     B B    BB B    B      B B      B B    
  BB   B       B      BB  B BB B  BB    B     B  B    B B     B                  B   B B  B  B       
    B      B     BB B     B       B  B B B     BBB B       B  B      B                          B    
  B BB B    B  B       B           B  BBB     BB B  B           B       B   B       B    B           
     B B    B  B    B   B   BB          B     BB  B  B            B  BB   B  B   B B B   BB      B B 
B B BBB      B BB B   BB    B  B    B           B          B     B     B                B      B    B
  BB    B B  B                B   BB    B B    B B        B   B    B  B   B   BB B B B   B        BB 
      B   BB     B   B     B B   B  B     B       BBB               B  B    B       B    B     B  B  
      B   B         B  BB          B B  B  B B B  B                     B         B      B   B      B
 B  B B    BB    B     B     B       B B  B    B  B   B              BB   BB  BB B    B     BB  B    
  B   B     B   B  BBBB BB       B     B BB B  BBBB    B        B     BB   B         B  B     BB  B  
 B       B    B  BB        BBB    B B B                        B B    B            B       B      B  
    B BBB BB B      B  BBB   B      BB           B B   B       B BB        B           B   BBB       
   BB     B B BB      B  B     B      B B   BB  B         B       B  BB      BB     B   BB       B   
             B   B     BB  BB B     B  B     BB  B  B B   BB      B  B  B B      BB   B    B        B
 B    BBB  B             B B   B    B   B B B B           B B   B   B B      B   B B     B       B   
B    B   B  B        B      B B     B     B        BB      B    B       B  BB           B   B B      
B B A BBBBBB         B  B BB        B       B     B B           B    B  B B  B B        B       B B  
  B B      BBB              B              B               BB      B  BB  B    B                 B B 
    B        B   B    B            B      B  B   B       B     B     B BB         B  BB              
 B        B B       B   BB         B            B B BB   B             B      B  BB      B        BB 
B                B          B B  BB       B       B   B B             BBB                    B    BB 
          B    BB     B    B      B B BB B      B   B         B BBB  B     B      B   B B B B     B  
  B   BB            B   B                 B           BB  B   B  BB    B     B   B   B  B  B   B   B 
    B           B      BB  B B B  B    BB            B      B    B       B           B B  BB     B  B
B   BB    B  B B      BB  B      B BB     B      B  BB   B              B   B       B          B     
     B    B B      B      B              BBB                           B B B   B         B B  B   B  
         B      B BB      B         B B  B B BB B   B B     B B                  B B  BB            B
  B   B B  B   B      B  BB           B     B       B       B      BB B  B  B B B        B      BBB  
        B  B  BB        B               B         B  B            B    B  B  B       B               
      B        B          B       B  BB  B             B   B B  B         B    B  B    B      BB B   