 B     B      B   BB           B       B  BB      B    BB        B    B B B    B  B   B     B        
    B        B                B  B  BB              B      B   B                      B     B     B  
 B  B B              BB   B BB    BB BBBB    B BB       B       B       B  B   B     B  B B   B     B
 B   B  B      B       B       BB B    B B B       BB     B  BB     B B B                 B     B    
       B B B   B         B       B B B  B   B                B             B BB    B                 
 B   BB            B   B  B B   B                     B  B  B  BB   B   BB   BBB  B        BB  B   B 
 B B B   B      B B  BB    B  B B   B B  BBBBB    B      B  BB BB             B   B  B      B        
B  B         B          B                 B     BB    B B    B      B         B                B B   
    B      B B        B         B    B BB      B  B             B          B     B   BB              
      B                   B   B  BB        B B     B  BB               B   B   B B                BB 
   B         B          B                                   B   BB      B    B              BB       
    B      B BB B  BBBB      B            B                 B  BBB       B     B     BB     B  BB    
           BB   B          B       BBB    B  B B         B   B     B    B B    B      B   B  B    BB 
    BB B     B B   B   B BB B      B    BB      B B B    B               BB  BB  B                   
             B B      B            B B B B  B BB  B BB       B B B         B  B  B B   BB  B BB B    
B B        B B      BBB           BB        BBBB B     BB   BB B    B              B   B B B       BB
       BBB  B   BB         B    BB      B   B B  BBB         B           B B        B   B B      B   
  B BBB         B B        B       B   B                 B             B   B    B        B B         
                B  B   BB   B     B       B B                B  B     B      B    B     BB     B B BB
 B        BBB   B BB      B       B      B     B   B    B         B       B    B       B    B B   B  
           B  B          B B            B  B     B  B     B  BB             BB  BB  B  B     B       
            BB B B B    B        B         B    B             B           BB   B  BB             BB  
  B B             B        B BBB             BBBB     B    B  B       BB B      B   B  B  BB  BB B BB
              B              B  B     B         B  B     B       B  B  B B   BB B   B      B     B B 
  B    B B       B        B        B B       BB BB  BB B B   BBB   B          BB B         BBB B     
         BB  B  B    B  B      B       B  B        B   B       B  B       B      BB           BB     
 B   BB BBB B  BBB BB                B    B     B            BB   B            B B    B B   BB       
           B       B    B  B  B B      BB    B     B  B  B   B                   BB  B B     B B     
 BB B        B     BB    B        B  B                B   B  B   B BB       B            B B    B  B 
           B B   B    B  B    BB     B  B   BB       B      B               B    B      B            
         B     B  BB B    B B  B  B B  B  B     BB     B    B B      B  B  B  B      B    BB    B   B
    B       BB    B    B B B B B B     B    B  B      BB      B   BB    B      B  BB              B  
     B   B        B         B               B        BB       BB            B             B          
       B  BBB      B  BB   B        B  BB  B       B   B   B    B   BB   B        B        B    T    
  A    B  B        B                          B              B  B            B   BBB  B B       B    
B   BB              B  B   B B                   B        BB           B         B BB B            B 
      BB         BB       B     BB         B B   B  B    BB     B   B    B  B               B     B  
      B B  BB     BB  B  B  B  B    B   B              B  B  BB B B   B    B   B    B  B BB  B     B 
 B        B      BB    B  BB     BBB       B     B     B       B B   B       BB B B  B  B    B  B    
BB   BB B B B     BBB        B      B B  B    B B  B   B  B     B   B     BBB       B      B     BB  
    B B BB        BBB          B  BB               B   B B                      B    BB          B   
  B         B  B     B  B         BB     B          B    BBB B     BB  BB BB B  BB  B  BB       BB  B
       B          B   B  BBB   B   B B B   BB       B        B      B  B  B   B B     B        B   B 
  B  BB   B     B  B B  B BB                 B BB        B     BB  B B              B  B  B    B  B  
          B  BB     BB B    B  BBB B  B           BB BB             B   B           B           BB   
   B    B     B    BB        B  B BB                B B     B       B           B    B B   B  B     B
         B  B B        B         BB BB  BB B   B   B         B     B        B   B   B     B     B    
   B  B  BB      B     B B   B  B  B         B    B B   B      B     B       B   B    BB        B    
 B      B        B         BB     BB        B        B B    B      B                BB    BB  B      
  B  B       B    BBB                 B  BB B B B B           B                   BBB           B    
    B   B          B    B  B   B  BB B     B      B        BB  B    BB B      B B BB        B  B  B  
B B  B    B                     B               B B               B B                B   B B    B    
 B                      B        B  BB  B   B B   BB     BB   B  B      B  B           B  B          
  B  B          B        B                BB     B   B B         B       B    BB    B   BB       B  B
   B       B    B  B              B B   B  B          B B  B   B         B           B           BB B
     BB  B      BB        BB     BBB  B       B    B    B BB        BB     B  B B B       B       B  
 B  B    B        BB   B  B B        B       B B  B B     B   B        B B B      B B   B      B     
        BB  B B  B   B     B B    B        B     B      B               B B               BB B  B BB 
 BB  B  B    B       B        BB     B            B B         BB B       B  BB      B   B  BBB      B
         B   B    BBB       B       B B  BB    B     B   B BB    B   B BB     B          BB          
 B              B           B B    B    B   BB   BB   B   BB B     B     B B              B B     BB 
      B   B        B B                   BBBB           BB  B    BB       B  B           B  B        
  BB  B             BB    B  BB                 B  B     B                B  BB     B      B B    B B
      B  BBB B      B      B         BB  B        B  B B  B B         B B    B        B      B B B   
       B    B B    BBB   BB   B  B B    BB  B   BB                B                  B               
 B         B  B  BBB B       B BB   BB   B  BB        B           BB       BB       B B       B      
 B   B   B             B       BB B B      BB        B    B   B  B    B     BB           B   B    BB 
BB    B               B      B          B    B        B  BB       B     B         B   B     B        
B B     B          B                      B           B B         B   B  B      B  B         BBB  B  
   B   B   B   B              BB    BB   B       BB B   B  B    B      BB     B            B  B      
B              B      B              B                 B    B  B B              B    BB B            
            B  B         B   B  B    B    BBBB  B     B    B                      B   B     B    B B 
 B        B  B   B B           BB   B   B      B   B             B      B B B B  BB   B      B      B
 B    B   B   B           B    B B          BB          B  B B       BBB  BB   B B                   
B   B   B B        BB   B BB  B    B    B       BBB B     B B   BB       B   B     B  BB     B B     
B  B               BB B BB B       B       B           B          BB  B          B        B   B  BB  
 B B   B    B   B             B  BB          BB   B    B   B    B          B    B         B    BB BB 
 B    B B          B   BB BB                      BB B    B       B      B  BB B                 B B 
                 BB     BBB            B B    B  B     B B B    B  B B       BBB      B       B   BB 
     B B      BB  BB             B  B         B          BB     B BB  B       BBB   B  B    B  BB   B
B             B   B      B         B      B B    B  BBBB  B               B   B     B  B       BB    
      B     B BB   BB   B     B       B           B      B   B               B B  BB      BB  BB     
   B   BB  B              B   BB    B  B    B B B     B  BB  B          B    B    B    B    B  B B   
BB  B             B BB B      B B    BB         B     B    B     B           B      B  BB   B     B  
B B  B B       B    B         B   B B B   B B   BBB         B             B             BB           
       B   B        B     B   B            B         B      B         B B       B      B BB    B     
 B               B   B   B           B     B  B  B  BB   B            B     B  B  B   B  BB     B    
B  B                 B B    B  B    B B   B    B  BB           B     B  B       B         B    B   BB
   BB       B       B B    B   BB   B       BBB  B B       B  B         BBB    B      BBBBBBB        
 B   B       B BB    B    B  B  B             B              B    BB            B B      BB BB       
     B     BB    B             B  B        B  BB       BB   B  B         B     B     B BB  B    B B  
        B  B B       B     B B                              B   B     B BBB               B     B    
 B   B    B B  B B  B        B     B  B B B       BB BB B       B   B B B       BBB    B B           
 B    B B          B    B    B B        B  BB   B B    BB B BB                 B                  B  
                      B  B   B B   BB    B B     B       B B     B              B    B       B       
BB      B     B     B  B  B     B B                               BB                B        B     B 
                  BB BB  BB  B                   B           BB    B          B   B  B    B     BBB B
B                   BB    B      B    B                       B               B               B      
B  B   B    B B  B    B  B     B        B BB       B B B    B BB BB   B      B  BBB   B         B    
 B        BB  B        B            BB            B B B      B B   B      BB               B    B   B
     B    B  B       B        BB B  BB    BB   B  B    B      BB   BB    BB  BB     B   B  B B  B    