        B          B   B B   B     B BB BB   BBB  B     B B B             B        B  B       B   B  
BBAB      B B           B     B   BB            B       B  B B  B     B      BB  B B        BB B B   
       B BB    BB  BB       B     B       B  B     B  B  B B   B  BB    B      B      B           B  
 B B B   B        B        B B  B   B     B    B B   B  B B       BBB       B  B   B   B    B B   B  
     B B     B BB BBB           B B   B B  B        B      BB   B     B         B    B               
     BB               B       B B  BB    B   B      B   B B   B      B          B    B     B B   B   
  B   B                   B B B  B          B     B B  B B  B    B    BB    B      BBB         B     
         BBB     B      B  B                  B  B  B B    B   B  B B           B       BBB          
  B B  B  B      B        B   B       B B   B   BBB       B          B  B  B B              B BB B   
    B   B     B   BB    B      B              BB     B              B B B    B  BB      B   B   B    
 B       B  B    B B  B B    B   B                               BB   B   BBBB BB    B  B  BB        
BB B    BB B            B B  BB    B     B      B    BB          B        BBBB     BBB          B    
  B B      B     B    B   B   BB   B      BB B B  B      B          BB               B    B   B  BB  
B   B                 B   B B BB     BB      BB    BB             B B          B       B         BB B
   B        B B            BB  B       BB   B  B B       BB B        B       BBB B                 B 
  B   B       B    B     B     B             B      BB             B B    B    B   B B     BB   B B  
 B     B    B     B   B  B B   B BB B  B  B                         B B       B         B   B  BBB  B
       B    B  BB    B   B                 B    B B BB     B   B   B BB B       B   B B    B   B     
 BB    BBBBB  B      B BB     BB      B  B             B       B B        B  BBB    B          B     
B     BB    B  B        BB  B       B       B       B   B    B BB      B BB  B          B       BBBB 
 B    B        B BB        B   B        B      B   B    B  B  BB   B  BB  B        B  B B   B       B
   BB    B     B  B            BB   B  B   B   B   B        BB      B          B                 B   
          B BB B  BB       B                     B B    B    B  B B       B B              B  B B  B 
      B  B   B      B              BBB       B B     BB   B   B  BB B                   BB BB B    T 
  B  B            BB  B            B             BB B    BB       BB                 B          B    
    B       B      B     B     B B   B      B           B      B     B   B B     BBB  B     B        
B      B  B     BB    B   B           B   B B    B            B           B  B      B   B  B    BBB  
                B    B       B B  B BB             B B   B       B        B  B  B    B         B B  B
   B  B        B           B B     B     B       BB                 B B                B          B  
      B    BB   B B      B  B      B   B       B   B BB BB     BB                    BBB             
     B   B                 B B   B B        B B B           B    B  B    B        B    B BBB    B    
            B   BB          B   BB          B        B B   B  B       B B B   B  B      B  B     B   
B      BB B   B BB             B                B BB     BBB   B   B      BB  BB B    B B            
B  B                   BB                   B   B   B          B       BBB  B       B  BB  B  BB B   
          B    B   B   B    BB   B              B           B     B B    BBB      B      BBB         
   B        B B    B   BB B  B   B     BB  BBBB             B             B        B       B B       
 B B       B BB                    B        B        B  B        B              BBB                  
         BBBB B B  B  B   B      B B BB    BBBB  B BBB   B    B    B                       B    B    
           B      B  B BBB    B BB                   BB    BB        B    B  B      B  B  B B        
  B   B B B B       BB   B B   B  B       BB    B  B    B        B   B          B           B     BBB
           B    B    B       B          B   B BB   B    B  BB BB     B     B   BBB  B    B    B   B  
    B     B   B       B               B    B  B B          B  B B               B  B   BB        B  B
 BBB         B B             BBB BB    B BB   BBBB     B B                    BB B    B    BB BBBB   
    B   B        B     B B     B  B  B   B  BB   B              B       BB    B        B  B          
              BB  B      B B   B  B                                  B BB   B   B   B        B   BB  
 B  BB        B             B B  B     B    B              BB              B             BBBBB  BB   
   BB    BB               BB   BB           B  B   B         B             B        BB               
       B              B    B B B  B     BB      BBB B   B B  B               B    B  B         B   B 
     BB       B   B                         B BB  B       B                    B         B           
 B B  B B           BB  B    BB  BB    BB             B      BB         B   BB       B               
            B   B       BB   B        B     B B  B   B            B  BB       B  B  B         B B    
  B      B    B         BBB            BB   BB   BB       B  B   BB   B                 BB  BB       
      B  B B   BBB        B            B   BB     B     BBB          B    B         B     BB         
    B B         B              BB  BB      B B  B              B    B        B   B      B    B  B   B
      BB   B               B B B     B  B        B           BB B B     B    BB     BB        B   B  
BB B B  B BB          BB     B             BB  B          B B         B           B  B  BB      B    
 B BB    BB   B         B         B  B BB  B      B      B     B B B         B            BB       B 
BB      BB    B B  B      B                B BB  B   BB       B B             B BB        BBB  BB    
    B           B B   BB  BB  B  BB    B            B    B B          B          B     BB   BB  BB  B
       BBB        BB  B  B    B      B     BBB B       B      B    BB   B  BB B B  B BB              
BB     B    BB      B B  B       B           B  B  BB   B    BB    B  B  B  B          B B      BB   
     BB       B B   BB  B              B   B B  B    B         B B   B      BB           B BBB       
B   BB B  B  BB   B B          B     B     B       B B       B               BBB         B  B B     B
B      B        BB    B   B      B    B     BB  B          B        B   BB          BB    BB    BB   
 B B     B B B                             B   B B B   B    B B  B  BB  B     B  B              B   B
     B    BB BB            B  B B    B BB    B B B B          B  B B         B     B    B    B B B   
            B B  B    B    BB      B B      B          B   BB              B    BB      B    B B     
        B B B B BB   B      B       B  BB B       B B     B    B  B       BB  B  B      BBB      B   
     B BBB        BBB BB   B                       B   B B        B   B              B  B     B     B
        BB       B    B    B              B  B  BB    BB  B  B              BB B   B    B       B    
  B    B        B    B                    B  B    B  B        B   BB      BBBB     B          B BB  B
   BB      B  B          BB    B   B     B BBB   BB   B   B  B    B        BB               BBB B   B
   B B     B    B  B BB  B B    B        B        B BB         B        B  B       B       BB     BB 
   B B   B                     B   B   B    B         BB B     B  B       B  BBB                   B 
   BBB B   BBB B            BBB   BB B        BB      BB B B          B     B B      BB    B         
 BB   B    B    BB B     B   BB       B  B     B B  B   B   B B   B       B  B B    B       B    B   
 B   B     BBB   BBB BB    B           B      B B            B   B                 B       B B B  B B
   B                  B B        B     B   B            B B B B           B  B       B    B B  B     
   B    BBB       B B    B  B  B B      B  BB B          B BB B  B      B  B   BB   B BB           BB
     B  B B       B        B BB  B     B B BB    BB B BBBB B  B     B    B BB        BB     B B    B 
  B     B                       BBB                   B                   BB     B BB   BB B BB     B
BB       BB B        B  BBB  B     B   BB B BB B           B   B   B     B   B    B  BB   BB B       
      B             BB  B BB   BB  B               B      B B      B             B                B  
    B                    B B       BB   B    B B     B B  B   B  B     B    B   B  B       B      B  
     BB B  BBBB         B            BB        B      B       B          B  BB  B           B B  B   
 B   B    BB B B  B            BB  BB   BBB   BBB                   B  B          B            B   B 
B     BB     B           BB  BBB  B B            B   B  B          B    BB        BB B   B   B  BBB  
 B    B    BB          B     B        B        B    B  B            B        B    B         B  B     
 B      BB  BBBB BB   B    B        B       B  B            B         B         B       B   B   B    
     B  B BB    B B   B          B         B       B         B           BB B      B     BBB   B    B
 B  B  B B      B      B       B     B B B                   B      B      B     B             B     
   B          B              BB        B B  B    B B B      B B  B   B  B B              B           
   B      B B B      B  B   B  B B            B        B B      B  B B      B            B       B   
       B      B           B    B  B    B                          B     BB   B    B   BB  B          
     B  B     B             B       B B    B  B B    B  B    BB            B    B    BB  B B      BB 
    B     B B  B B       B   B   B                     B           B      BBB   B   B  B           B 
 B                  BB                B            B B  B     B      BB B  B  B    B    BB   B     B 
BB   B B B   BBB     B    B       B    B  B  B   BB B       BB   B           B    B           BBBB   
                 BBB   B  B     B BB     B          BBB    BB          BB B             B       B B  
 B      B   BB          B         BB   B     B B   B   B  B               BB  B         B        B B 
   BB B             B BB               B B      B B  BB     B B BB  BB        B B B B      B  B BB   