    B     B                   B     B  BB  B B   B  BB   B       B         B      B B B B    BB      
   B    B      B  B               BB B     BB      BB   B             B B  B  B    B  B B B       B  
    B         B    B       B      B        B B        B            B  B  BB   BB  BB B     B  B      
B       B    B    BBB  B  B      B B    B  B  B B           B   B    B B          B B              B 
    B   B               B     BBB   BBB   B B      B  BB B BBB        BB   B        B   B B        B 
   B  B B BB   B B         B    B B B  B         B B B     B  B    B        B  B    B         B      
    A B B   BB    B    B   B               B  B B    B   B BB       B                               B
        B           BB      B  B  B    B   B  B  BB         B    B  B       BB     BB     B       B  
   B B          B    B  B B   B B    B    B       B                 B B                B B           
   B                          B  B   B      B    B    B    BBB BB     B   B          B B            B
BB B  BB          B        B  B   B        B                B            B  B         B   BB        B
    B   B                               B    B B B B                  B     B B   B  B B    BBBB     
            B        B              B       B       B          B B       B   B            BBB   BB   
B    B       B B  B B      B B      B    B  BBB  B    B                    BB B BB B BB B     B      
BB     BB    B    B      B     B B B      B  B        BB       B        B    B            B  B       
B B     B      B  BB B BB        B BB         BB B B  BB  B      BB B B   BB             B     B     
   B  B    B          B   BB  B           B                    B    B                 B    B   B     
 B    BB           B B  BB B  B   B   B        B BB          B   BB        B     B    B    B B       
    B        B  B B        B BB     B       B         B   B     BB            B            B    B BB 
B        BB  B        B  B        BBB       B     BB   B  B    B     BB     B B            B       B 
     B          B  BB   B     B       BBBB   B       B  B  B          B     BBB     B                
  B   B      B      B    B  B                 B BBB B BB    B   B    BB      B B          B      B   
      B      B    B         B                       B  B B    B BB        B    BBB   B BB   B     B  
B   B B  B          B B   BB      B          B           B       B       BBB B     B      B         B
      B B  B    B      BB   B    B     B       B     BB BB B B     B  B B  B  B      BB              
     B   B B      B          B   B     BBB  BB    B                        BB B    B   B B        B  
B  B                    BB            BBB          B       B      B   B     B   B        B          B
   B B      BB  B B        B  B B   B                 B B        BB   BB  B    BB      B   B BB  B   
        B         BB  B B B     B         B   B   B B      B         BB   B B    BB           B     B
B          B B             B B B    B        BB                  B          B B         B            
B    BB  B          B   B          B  BB   B   B              BB    B BB  B  B     B   B B        B  
      B   B  B         B B B     B B                            B  BBBB B   B  B B  B        B       
B                 B   B     B B BB            B                BBBBB B  B B     B      B   B     B  B
           B BBBBB   B B B    B     B         B    B  B             B            B    B        B    B
 B      B  BBB  B          B                   B         B         BB  B       BBB  B B  B   B    B  
 B    B        B B      B B        BB       BB      B     B  B    BB       B  B    B    B  B  B     B
   BB        B  B   B B      BBB    B                B BB B        B  B  BB B BB BB BB  B   B   B   B
BBB      B BBB        B BB B    B                      BB   B    B     B    BB   BBB    B B     B    
   B B       B       BB    B BBB B          B           B     B B                B    B  B   B       
    B               B     BBB       B    BB            B       B    B    BB  B        B          B   
 B B B B     BB    BBBBB       BB    BB                       BB BB   BB    B  BBBBBB B    B    B    
BB    B  B  B      B           B  B         B      B   BB  B  BB    BBB           B        B B B    B
                 BBB       B     B   B      BB      B            B        BB        B  B    B B B    
   B          B   B BB  B           B BB       B      BB           B    B           B       B     B B
 B   B       B  BB  B     B       B  B     B BB   B  B      B     B      B B                      BBB
   B    B      B    B              BB  B     B    B     B  B    B       B B  B BB B B B  B  B        
    BB   B   B                B B               BB         B   B          B   B    B   B   BB   B  B 
 B       BB  B        B      B B B    BB B B  B B  B  B B B B  B B            B    B    B           B
B        B   B    B    B    B           B       B   BB       B B     B            B             B B  
       B BB       BBB               B     B B B BB    BB        BB      B     B B B    B    B  BB B  
     B   B  B      B                BB      B BB     BBBB      BB  BBB     B   B  B BB         B B   
       B  B             B  BB     B    B    B B            B B B          B    B     BB   B BB      B
   B    B     BB   B              B B                 B B      BB         BB B  B       B     B      
         B B  B   B       B B B  B   B   B  B B               BB  B B  B  B       BB            B B T
    B          B  B    B B    B  B        B B      B       B  BB  B      B B   B B  B        B       
   B   B            B B     B        B                        BBB B  BBB      BBB   B        B B     
       BB         B    B  B B   B B   B B    B  B           B    B     B  B    B        B            
        BB B       BB        B B      BB    B  BB B B  B B B             B B B          B       B    
   B B     B      B  B                         B              B        BB          B     B     BB    
B    BB BBB B         B   BB      B       B BB B        B B            B          B              B   
      BBB  B   B    BB          B   B            B                B B  B           B         B  B B  
   B  B           B  B     BB         B B      BB           B      B   B  B         B B BB  B      B 
      B B        BB           BBBB B BB         B                   BB         B       B          B  
B    B   B   B B B             BBB       B      B         B     B      B         B  B  BB        BB  
                                BB  B BBBB  BB      B BB   BB  BB          B    B         B  BB B   B
 B        BB       B    B      B    B         B             B B            B B       BBB B    B      
B            B    B        B               B    B     B B B B B   B BB     BB B         B          BB
          B    B            B   BB    B   B   B        B  B  B   B    B B            B         B  BBB
B B     B              B  B B BB    B B     B     B       B B   BBB  B        B     BB   B  B  B  B  
      B   B        B    B B          B   B        B           B             BB      B              B 
  BB        BBB   B    B B  B      B  B     B      B B          B         B      B      B    B  B   B
B     B       BBB   BB           B                             BB       B B      BB  B            B B
BBBB           BB           B              B       B  B  B  B     B   B   B    B     B        B      
      B B  BBB B     B B     B  B BB  B   B     B BB       B  BB   B  B    B B       B  B   B B     B
   BB  B   B B   B    B  B  B              BB   B                                       BB B         
B    BB      B B  B  BB    B       B    B  B   B B B      B B B     B        B  BB    BB    B        
  B B            B   B B    B   B   B           B BB     B  B          B B  BB    B       BBBBB    BB
       B   B B     BB  B BB    B    B B         B   B       B B           B       B  B   B           
      B BBB    B     B                     B           B   B    B        B     B BB  B B       B   B 
        B  B              B B   BB  B B BB    B     BB      B B      B   B    BB BB     B    B     BB
   B B    B    B B B B    BBB  BB      B    B     B  B           BBB             BB   B         B   B
 B  B  BB                             B      B BBBB       B         B    B     B    B   B BB         
     B  B B         B          BB B      B    BBB  BB                  B  B        B      B          
    B  B       BB      B          B           B    B  B          B         B   B     B B   B   B     
 B  B    B        B   B       B  B    BB   B     BB   B   B  B       B  B   B      B         B     B 
B     B                B B   B     B        B BB      B   B    BB         B         B            B   
B    BB    B         B B  B        B   B BB       B B B    B BB   B  B       B B B B     B B B B     
            B  B B BB  BB        BB B B B         B B B   B     B   B B        B    B B B          BB
    B   B    B      B              B B      B   B  B  B  B  B   B B B    B    BBB        B BB        
  B B            B       B BB   B B      B   B B               BBB          B      B   B      B  B   
          B                  B B         B  B   B    B    BB B B     B       B               BB    B 
                    B  B BB              B   B        B   B   B            B BBB      B      B BB  B 
       BB      B BB   BB  BB                B     BBB    B         BBB      B    B B B B          BB 
          B   B  B           B BB      B     B B           B   BB             BB BB B   B B         B
           B   B   B    B   BB    B         B  B B                     B     BB         B B B  B     
    BBB B    B      B  B    BB B        B  B  B       B              B        B          B  BB   B  B
 BB B       BB   B    BB BB   B      B   BB    BB             B                 B  BB               B
 B            B  B B      B   B  B       B      BBB          B         B  B      B      B      B B  B
        B      B   B B       B               B   BB                     B B B B        B B           
   BBB       B        B       B         B B   B    B BBBB      B     B   B     B     BB B B B    B   
     B     B BB  B          B B  B                     B    B B B      B           B    B      B     