    BB BB     B   BB B  B     BB    B B          B  B     BB B    B BBB   B       BBB   B   B  B    B
             B    B    B     B    BB       B     B      BB   B            BB   B                     
          B   BB  B      BB           B  B  B           B  B           B  BB B   BB  B B    B B   B  
B   B  B      B    BB         B     B  BBB        BB  BB        B B    B         B BBB    B   B  B   
     B    B      B       B    B   B       B      BB   BBB    B B         BB  B  B B                 B
      B   BB     BBB   B      BBBB       B     B B BB B B            B BB       B B     B B B  B   BB
   B      B B   B B   BB      B  B    B    B          B   B    B B  BB B    B              B    BB   
B              B BB      B       BB BB   B  BBB    B     B   B    B B   B   BB        BBB     BBBT   
B         BB BB   B    B  B    B    BB                 B   B        B       B   BB BBB    B       B  
BB     B B             B    B B                      B    BB  B    B  B            B  B B B         B
        B  B       B     BBBB B      B                     B       B   B B        BB  BBB    B       
B        B    B            BB  B B     B         BB B  B      B           B B   BB         B  B     B
B          B       B           B B B     B        BB    B B      B B B      B   B    BB   BBB B      
 B    B   B   BB     B    B B B       B             BB     BB B   B BB          B                B B 
     B BB    B                     B      B   B  B       B         B           B BBB         B B     
B       B     BB  B    B     B    B                   B        BBB            B B   BB   B     B  BB 
  B                               BB B      B  B   B      B B             BBB    B   B    B    BB    
              B   B   BB B          BB   B BBBB        B       B                  BBB    B    B      
B  B       BBBB B B     BBB      B   B   B       B     B  B    B B            B B      BB        B  B
              B  BBB  B      BB     B BB  BB               BB     B   B   BB  B                  B   
      B          B       BB             B B    B         B B     B         BBB         B B      BB   
    B    B   B     B B      BB      B B  B B    B  B           B B B     B B       B     BB    B     
B              BB   B            B     B  B B             BB  BBB     B B                        B  B
    B          BB  B            BB      B             BBB   B   B       B  B B            BB    B B  
         B                     BB BB BBB  BB  B    B   B  BB BB B   B  B    BBBB        BB   B       
  B  B B            B  B    B     B            B  B     B     B         B B        B     BB  BB  B   
                 B  B                 B                             B  BB  B B    B   BBB            
     BBB    B  B       B               B      B  BB       B   B      BB                       B      
   B        B       BB   B  BB  B    B            B    B                B      B      B          B   
B     B B  B    B    B   B    B  B B B    B        B          B                      B        B      
     B    B      B        BB        BB      B B    B   B BB    B         B    B  BB B  B           B 
           B B   BBB B B        BB      B B        B     B B      B     B  B    B        B BB  BB    
       B      B B     B            BB  BB B  B      B B                    B          B   B      B   
 B     BB      BB     B    B B               B B B              BB   B   B        B  B    B       B B
  B   B     B B      BB  BB B          BB    B    BB   BBB           B      B   B  B      B      B B 
      B           BB B  B      B    B   BB    B          B    BB   BB B       B      B   B       B BB
 B             B BB         B        B              B      B    B B     B  B B B  B  B  B     B   B  
 B  B B     BB    B                 B   B            B B      B B B        BB B     B           B    
 B B B                 B   B    B  B   B       B             B B              B  BB        B B    B  
         BB  BB   B    BBB B B             B           BBB  B  BB       B   B BB       BB B B     B  
 B       B B  B   B            BB    B     B          B              B B              B  BB         B
   B   B    B  B  B    BB   B              B  B B          B       BBB B B    B     B B  B           
    B  B       B B   B      B   B      B        B B B   B   BB BB  B                B    B B  B B    
B  B  B B B    B  B       B  B        B     BB     BB  B  B        B           B    B        B B     
   B       BBB    BBB  BB           B  B     B B  B   BBB B     B     B    B        B   B B      B   
  BB         B  B                    B   BB   BB B   B B BBB                 B   B  B           B   B
          B            B           B     B   B B BB     B    B      B  B     BBBB BBB    B   B     B 
   B                      B  B           B      B      B B        B B    B   B  B       B      B     
      B       B BB       BB    B          B              B B   B B    B    B     BB B  B  B   BB   B 
   AB   B       B        B    B    BB  B        B  BB  BBB                B      B    B           B  
    B        B       B  B B  B  B      B  B      BBBB     B  B B  B       B     B      B      B  B BB
     B  BB B   BB B           B   B        B B       B      B        B B    B    B BBB  B  B       B 
 B   B  B    B      B    B  B  B    B  B    B   B        B         B   B  B     B  BB    B         B 
  B B  B          B         B     B               BB     B             B      BB    B   B     B   B  
B     B B BB       B      B   B    B B    B  B      B        BB   B    B   B  BB     BB           B B
          B    BB   BB   B   B BBBB               B BBB               B   BB   B    B B B            
BB    BBBB             BB    B   B         B    B B      B    B   BB        B  B    B    B   B       
    B B B         B B   B         BB BB      B   BBB    B   B B B BB       B            B            
                B     B BB      B     B      B            BB                              B    BB  BB
           BB    BB          BBB  B BB     BB  B             B B   B B       B B    B        B  B    
 B  B B  BBB   B        B    B    BB    B    B  B    B     B B   B B   B B  B   B   B       B      B 
B       B   BBB   B         B B      B            BB B              BB  BBBBBB   BBB         B  B    
 B   B   B     B    B         B  B       B    BB           B BB BB              B BB BBB     B  BBB  
        B           B B B    B      B     BB  B  B          B         B B  B B   B     BBB BBB  B B  
 BBB   B  BB      BB   BB   BB   B    B      B                B  B  BB   B B     BB B     B B BB B   
     B     BBBB       BB        B        BB B  BB B BBBB B             B BB       BB    B     B    B 
B      B  BB B  B            B        B         B                  BB           BB      B B        B 
     B  B B           BB   B   B            B       B B         B B            BB             B  BB  
B B B B       BB    B  B     B B BB B  BB    BB     B      B B          B B    B  B      B           
 B    B                               B         B       B      B     BB         B    B  BBBB         
      B   B     BB  B  B  B   B    BB    B  B   B B   B    B         B B     B B    B     B   B B   B
     BB   B       B     BB  B  B   B B      BB    BBB      B  B  BB          BB  B   B  B     B      
     B     B        B            B     B  BB B B  B  B  B B           B    B              B          
       BB   B B           B B     B        B  B BB    B B    B B B    B BB  B      B   B     B B     
   B   B  B          B          B B       B B B B       B       B         B B B                B B   
  BB  B B   B BBBB    B B     B    B      B        BB       BB             B    B           BB       
     BBB  B   B         B    BB    B    B B    B    BB B     B   B  BB    B   B   B            B B   
     B        B  B   B      B B B  B         B    B  B  B  B   BBB   B         B  B   BB B B B      B
B   B B   B        B   B          BB      B          B      B       B                           B   B
 B    B                  B   B   B         B    B    B       B   B      B    B         B     B B B   
BB  B             B       B            B   BB         B   B       B         B BBB     B BB B    B    
      B      B   B  B   B   BB   B   B B    B      B  BBBBBBB                 B    B            B   B
B     BBBB   B  B   B  B    B    BBB    B   B B BB     B   B          BB         B B     B  B    BBB 
    BB        B       B   BB      B   B   B        B BB  B      BBB   B    B       BB             B  
       BBB B    B  BB   B       B      B       B    B   B     B    B      B           B    BB       B
                   B        B   B         B  B B    B B    B         B   B     B      B            B 
           B B  BB     B    B           B BBB   B   BB        B       B    BB        B   BBBBBBBBB B 
          B B   B B B B       BB        B   B        B  B B   B      BBB BB   BBB      B         B B 
    B B               B        BB               B  BBBB   BBB   B    B BB      B    BB B BB    B   B 
                 BBB B B          B   B B  B   B  B   B BBB                 B           B  B     B B 
         B  B   BB  B   B         B   BB           B                  B     B    B B     BB     BB   
   B          B BB          B    B   B        B     BB     B            BB B    BB BBB  B B   B  BB  
    B        B   B   B  BB            B B              B       B  BB  BB       B      B    B         
        B   BB B                B                 BB             B          B               B BB     
  B      B    B B  B     B      B           B           B        BB   B       B B B     B   B        
B   B       BBB B    B B       B    BB     B        B           B   B  BB  B B B   B   BB        B   
           B               B BB    B  B   B             B     BB  B   BB   BB   B   B       B        
B      B   B      B  B      B    B  BB   BB B  BB                           B                B       
BB  BB  BB              B            B    B                   B B  BB            B  BB            BBB
   B         B    B  BB  B B           B     B                B         B   B     BB         BB      
B      B B   B B                 B         B       B B      B B BBBB    B    B  B B B    B           