        B   BB      BBB B    B   B  B  BB B   B    B           B    B     BB   B   B      B   BB     
      B             BB B  BBB       BB B B       B        B     B     B     B B             B        
  BB     B   B B    BB       B B   B B    B     B B    BB   B   B             B B   B    B    B B    
  B    B     B B    B   B    BB  B      BB B B       B      B                           B     B B    
    B BB B  B         B  B B   B                         B B      B      B        B  B  B        BB  
 B BBB         B   BB           BBB  B  B         B BB B        B  B B                B B       BB  B
B  B      B      B   B       B   B                B         BB  B BB       B       B    B B    BB    
               BB        B B      B         B B   BB B B   B       B B  B               B        B B 
   BB BB      B B       BB     B  B  B       B   B B     BB  B    B       BB BB               B   B B
     B  B  BB B         B   B                         B     B B              B  B            B B  B  
    B     B              B BB                B B      BB   BB    B    B    B       B             BB  
    BB       B         B   B         B B     B B        B     BB    B  B BB  B     B BBBB    B       
      B B       B B      B    B B    B     B              B  B BBB B               B     BB B       B
 B      B   B B     B     B B  B     B   B      B            B           B      BB  B         B      
   BB   BBBBBBB                 B              B  B           B   B  B     B          BB    B        
     B   BB        B B       BB   B   B B B          B              BB B  BB              B  B  B    
  B   B  B BBB   B    B    BB   B  B         B  B B       B    B     BB           BBB B  B    B B B  
 B                B      B     B   B     B         BB     B     B       B  BB B   B   BBB     B  B   
 B         B   B            B            B   B   BB       BB    B           B      BBB BB            
B   B    BB B B               B B               B       B     BB              BB                   B 
BBB             BB     BB B   B    B           B    BB  BBB     B        BB  BB BBB           B  B  B
                         B B     B      BB   B   B B    B   B  B                 B    B  B        BB 
 BB   B     B  B                 B   B  BBBB BB B           B  B BB  BB BB    B    BB     BB         
   B B         B   B  B  B       B     B  BB B     B  B      B        BB    B            B    B  B   
    B                B    B B    BBB       B   B     B          B        B    BB  BB   B  BB B       
             B      B             B BB  B    BB   B                 B BB   BB B  B B    B    B B     
     B          B     B B            BB B   BBB     B     B     B   B    B  B       B       BB  BB B 
B B                 B          BBB       B B B  B  B   B   B                  B     B      B  B   B  
 BBB BBB       B   B     BB     B      B  B B     BB                BB    B  B B   B           B     
    BB    B  B B   B  BB   B   BB  B B   B BBB    B  B     BB  BB       BBB           B B       B B  
   BB  BB       B B  B    B    B        BB     B      B B          BB      B  B B    B  B        TB B
  BBB B B B       BB     B     BBB        B B         B     B  BB B             B B    B             
  BBB    B     B      B  B   B      B    B B    B   BB           B  B         B      B B  B     B    
 B  B BB   BB     B      BB         BB   BBB        B      B B   BB    B       BB B        BB      B 
 B         B B       B B  B BB  B               B         BB        B              B    BB    BB    B
 B      B   BBB   B     B            B  B        B     B              B       B  B B  B  B       B   
    B B   BB    B B            B     B   B         B       B  B B  B      B    B    B  B        B B  
             B         B     B  B B B  B       B B            B    B       B          B  B           
       BB    BB   B           B  B      B B   B         B B  B       BBBB B   B  B   B B    B  B   B 
            B  B     B   B      BB  B    B         B       B                               B         
          B         B            BB  BB B       B         B     BB               B B   B B        B  
        B  B    B   B      B B        B  B    B B   B    B  B      BBBBB     BB    B  B              
      BB     B  B    B           B  B    BB  B      B  B        B   B    B B          B BBBB  B B   B
       B B    BB   B        B      B    B               B     B         B           B   B            
       B                B           B  B              B         B    B           B    B           B  
   BB        B        BB        B         B       B          BB         B   B BBB BB                B
B    B   B B               B   B B   B       B     B  B         B   B      B B     BB B BBB          
  B  B BB   BB       B  BBB BB    B      B  BB            B  B BB    B B BB B       B B     B   B  B 
  B                      B    B    B    B  B   B                B      B          BB    B     BB     
B  B   B     B       B   B            B  B B                   B  B                 BB           B   
B                 B  B        B      B  B    B       BB    B    B     B      B BB B     B B  B B  B  
                         B B  BB      B  B B  B      B   B    BB B B          B    BB                
B         BBB     B                B  B         B B   BB   B           B   B       B BB    BB      B 
 BB     B     B          B B  B  BB     B    B           B  BBB B            B      B    BB   B      
      B       B B B      B        BB  B   B B              B      B   B    B   B B   B          BB   
A         B  B      B  BB   B  B     B  BB    B  B     B B   B  B       B B   B B  B B     B B    B B
B   B                       BB          B   BB              B      BBB BB B     B BB          BBB  B 
 B    B            BB     B B        BBB          B    B        B        B  B  B    B  BB BB       B 
B          B         BB  B B B B  BBB B B  B       B     B     B     B    B  B B  BB  B   BBB  BB    
 B      B  B             BB        B     B      B            BB    B     BB         B B      BB  B  B
 B  B   B          BB     B B      BB    B       B    B          BB B      B             BB   B B    
B  B             BB  B  B   B           B    BB          B   B BBB  B                 B          B   
 B    B  B    BB          BB B B B       B  B        B    BB    BBB       BB      B B      B    B    
         B         B B  BB B     B B      B   B   B B   B                        B                  B
     B B          B   B                   B     B        BBB BBBB BBB       B       B         B      
    BB B     B     B B  B  B          B B         B  B            BB     B B    B      B  B   B   B  
          B                B           B  BBB  B BBB B  B      B   BB B       B    B            B B  
        B       B             B        BB   B  B BB                        B  B  BB         BB  B    
    B     B B           B B  B   B    B            B      B      BB        B B BB      B B B B   B   
  BB        B    B    B  B           B        B      B       B B   B           BBB B B         BBB   
     B       B           B B   B                B      B       B      BB B             B B B         
     B       B     B B BB B BB                     B B   BB B     B B       B      B     BBB     BBB 
B    B BB                   BBB B   B  BB  B   BB B  B      B             B B B  B B  BBBB           
B   BB    B B B       B                        BB   B B   B B          B      B  B                B  
 B      B              B  B  BB      BBB   BB B        BBBB  B B        B BB       B             B  B
 B          B         B          B                 B   BB      B  B   B    B       B   B B    B    B 
    B B      B     B     B  B    BB    B       BB     BB B            B B   B B    B  B        B B   
               B   B              B BB            B        B B       BB    BB       BBB   B BBBBBB   
 B              B B B       B         BB  B BB                 B B      BB        B       B          
  BB  B  B     B                     B    BB    B  B   BB B  B         B     B   BB        B         
  B      B B     BB  B    B  BB       B  B      B  B B  B    B  B   B   B       BB  BB               
  B    BB     B BB  B   B   B      B   B      BB       BB       B      B        B  B           B     
      B  B         B BB BB         BBB          B    B         B   B    B   BB   B         BB  BB B  
B B     B  BB  B    B     BB       BB         B       B  B           BB  B B  B    B     B  B   B BB 
   B    B   B    B     B   B         B          B          B     B B          B       B  B        B  
     B  B               BB   B BB  B        B         B        B   B B   B     B B     B B    B B    
       B B   B        BB       BB  B B     B  B   B B      B             B     B BB               B B
    B    B B   B BB               B  B   B   B        B  B             BB      B   B   B    BB   B   
  BB   B        B  BB    B    B    B      B   B         B    B     BB   B   B     B  B        B  B   
   B   B                  B B        B B         BBB      BB    B                  B   B            B
    B             B B   B             B BB   B            B               B   BB    B      BB B    B 
     B    BB     BB B    BB          B          B   B  B   B   B        B       BB      B B  B    BB 
  B   B           B B     B    BBB   B      B   BB   B BB     B   B   B       B           B B    BB B
              B     BB           B    B   B  B  B B B BB     B B               B B      B   B        
   B B   B B    B   B         B B   B          B  B     B     B  B              B B             B    
     B    B            BB          B B        B       B B       B B  BB  B B B   B    B        B    B
      B      B   B  B    BB      BB B          B    B BB       B          B BB            B    B     
     BB B BB   BB   B  BB   B B         BB   B BB  BB          B   B  BB B         B  B     B  B     
B B  BB           B    BB B      B B     B B    B B B B               B               B   B BB B     
 B         B   B      B     B           B      B        B   B         B  BB              B      B    
  B            BBB   B       B          B B   B        B  B     B   B B    B B           B        BB 