B  B    BB B               BB B           BB B  B         B      B     B  B   B    B BB      B       
    B   B      B B      BB   B   B                           BB  B      B   BB       B B B          B
 B   B   B  BB     B   B  B   B      BB                 B BB       B     BB B B B     B       BBB    
  BB     B B B         B        B           B            BBBB  BB   B B   B         B       B  B     
B   B B   B         B  BBB              B B    BBB B    B        B B                B B      BB      
      B      BB          B B B      B    B   B B       B  B  B B   B    B   B          B        T B  
          B   B   B B          B   B  B    B      B                B   BB     B    B BBB            B
 B B          B         BB       B  B  B    B       B B           BB      B   B            BB   B  B 
B  B B           B BB B         B B  B        B    B  B BB        B      B      BB BB       B        
  B   BBB               BB  B                  B       BB B  B BB                 B  B      B BB    B
    B     B             B  B B BB B  BB  B      B         B  B  B    B  B       B  B  B BB        B  
               B       B          BB     B   B        BB B         B BB            BB                
    B  BBB B         B  B    B    B   BBBB BBB     B  BB BB          B BB        B    BB     B  B    
             B  B   BB    B  B   B      BB                   B  B     B  B     B B B       B B B     
B       B      BB B   B    B  B          B   BB            B  B    B     BBB    B     B       B B   B
          B     B  B    B                    B   B                  B     B B B         BB      B  BB
   B      B                     BB    B  B  B   B  B   B        B       B             B   B          
B  B BBB  B  B  B BBB B             B B     B           B  B BB   B    BB   B   B B   B            B 
      BB  B        B       B  B  B B     B     B       B    BBB      B B B     BB      B    B      B 
    B  B B   B   B  B       B  B      B  B BB          B    B   B B B  B      B             B        
  B        B       B     B    B B   B           B   B     B           BB   B   B  BB  B   B   BB    B
 BB  B   B   B  B  BB     B    BB      B   B     BB    B  B           BB B     B  B      B   BB B  B 
             B   B      B                   B B B   BB  B BB   B   B     BB  BB B             B  BBB 
        B   B           BB B     B    B B         B     B  B  B B      B     BB             B  B     
     BB    BBBB   BB     B     BB            B    B B      B B        B        B   B BB          B BB
            B                 B BB      BB   BB  B   BBB B    B  B       B      B             B      
  B       B               B B                BB    BB       B         B     B  B      BBB B     B    
         BBBB    B         B      B     B B  B  B  B   B        BBB B   B B BBB       B              
B  B     BB             B  B   B       B     B             B          B    B   BB B B         B      
  BB  B            B     BB     B B     B       B    B  B    B                  B   BB     B         
  BB  B         B      B                          B         B         BB            B    B B     BB B
 B   BBB    BB    B  B   B B     B    B   B      BB      BB    B             B  BB B                 
 B   BBB             B  BBB B   B      B        BBB                  B B B BB  B   B            B B  
  BB      B     B     BB  B     B     B  B        BB B B     B BB           BBB      B     B    B    
    B  B    B     B       B B B  B  B    B  B B   B                    B         B   BBB B         B 
 B B  B  BB  B B        B     B        B   BB           B              B  B          B         B     
     B  B     B                     BB    B       B    BB     B  B B        B    B            BBB    
 B             B     B B          B     B B  B  B    B    B      BB                BBB     B    BB   
            B          B   BB       BBB  B B       B BBB   B           B         B             B B   
         B   B B    B   BB   B   B        B B  BB       B                 BB    B   B   B        B  B
     B          B  B BB  BB BB   B   BB             B   B  B B  B  B  B B  B B         B    BB  B    
        B B    B  B  B    B     B   B   B BBB  B   B           B                B  B              B  
 B B    B         B  B      B B      B          BB        B  B BB   B       BB                  BB   
     B     BB B     B     B    B   B     B       BB   B  B B    B        B  BB   B       B    BB BB  
B         B B   B       BB        B   B      BB B     B    BB       BBB          B   B   B     B     
B      B   B B B    B  B      B                  B B  BB         B        B B    B      B  BBBB  B   
             B    B                  B B       B      BB    BB      BB B         B   B     B  B      
        BB B         BB  B    B  B                  B                B      B       B  B         B   
B     BB     B  B B    B    B BB        BB  BB   B       BB        B  B    B  B        BB  B      BB 
  B       BB             BB      B B         BB              BB  BBB    B   B          BBB           
 B    B          B    BB       B   BBB  B   B    B        B B B   B   B  B      B    B B      B   B  
  B                       B     B        B   B     B  B BB     B            B   B           BB       
  BBB B     B   B BBB B  BBB    B  B       B    BB     B  B     B    BB B    B      B B       B  B   
    B         B    B B    B  B  B   B   B  B             B BB    B      B B   B       B    B B B    B
BB      B        B  BB       B   B           BB   B B B          B    BBB    B     B   B             
    B   B       BB BB  B   B                B        B    B BBB B    B               B BB  BB    B   
  B    BB        B      B         B  BBB  B  B BB  B            B    B  B   B    BB      BB B   B B  
 B  B          B     B  B       B       B  B   B  B      BB    B B   B     B       B B    B      B  B
  B BB     B        B B      B       B B   BB   B                         B                    BB  B 
B         B       B  BB      B B     B B  B   B   B   B BBB     B      B                        B  B 
B       B  B  B B         BB          B   BBB  B B   B    BB      B  B         B B    B              
   BBB  B B  B                  B    BB      B BB B   B B    B    BB    B   B             B       B  
B           B         B  BBB   B B   BBBB      BBB BBB    B B   B  B   B         B                   
BB      B       B        B B  B      B               B      B   B B          B B  B B   B       B    
   BB          BBB B       BB  B     B   B B  B  B       B B B B        BB BB BB B      BB           
BB         B    B  B                           B B    B   B     B B B              B B  B BB  B B BB 
 B      B B     BB B   B      BBBB    B        B            B B        B                     B       
  B B       B  B   B   B    B   BB B           B B       B       B     B       B BB B    BBB   B  B  
  B    BBB  BB  B      B                BB B    BB    B       B        BB    BB              BB  B   
B     B B                      B   B BB   B          B   B B B   BB   B  BB  B   B     BB B      B   
B    B     BB BBB  B    BBBB   B       B B  B B    BB   BB             BB         B    B      B B    
 B   B     B B  BB B     B B     B  BB B    B     B        B B         B   B      B   B            BB
B B        B     B          B   B     B  B   B    BB       B               B   B   B   B      BB    B
                         B     B  B BB         BB   B  B             B  B B     B  BB       B        
B       B   BBB     BBB   B BB B B     B   BB  B       B   B    B B BB       B     BB     B          
B B             B B B       B               B    B      B       B                    B  B            
    B             B     B   B       B B   BB         BB   B                 B   B       B B      B   
B BB B     BBB  B  B                  B    B B   B BB                B    B                 B   B  BB
B    B B       B    B        BB B B  B  B B      B      B     B  B            B  B          B  B     
  B  A  BB      B BB    BB          B        BB   B BB                  B B   B           B B        
               BB     B B    B           B BB       B     B    B   B              B   B   B     B B  
  B        B    B                 B                  B             B  B B   B     B      B     B    B
 BB      B    B B    B       B     B       B   BBB  B    B        B  B B B BB      BB              B 
           BBBB     B   B         B      B       B    B               B BB  B B     B BB   B  B   BB 
 BB         BB B    B     BB BBB BBB             B    BB   BB    BB     B B       B     B           B
     B   B B                  B  B         B     B           B B     B B    B B      B   B B  BB     
                         B     B                              B           B       B B  B  B     B    
 BB   BB   B     B B              B    B  B  B B              B               B  B  B     B  B       
 B B                          BB     B   B    B B         B            B B  B B BB   B   B       B B 
 B B B      B                B       B     B    B     B BBBB      B      B  B         B  B B  B BBB B
   BB           B              B      BB   B     B             B B      BB     B     BB   BBBBB    BB
                 BB B   BB B    B  B B               BBB   BB                         B B   BBB      
  B  BB B     B B B       BB B       B          B   BB     B   B BB   B         B       B         B  
    B BB   B    B B        B  B B   B        B            B     B                   B               B
  B   B   B   B BB  B B  BB   B    B  B     B  B  B    B        BBB   B  B         B                B
BB   B  B       B B  B       B  BB B    B       B  B     B     BB B    B          BB      B         B
      B     BB     B     BB B    B   B B   B     B  BB                   B B  B      B BBB  B     B B
   B        B     B      B      B B          B  BBBBB      B   B B  BB  BB      B                    
    B  B                      B BB   B      B    BBB B   BB           BBBB      B               B B  
    B BB  B B B  BB   BBB B B                 B  B B   B B  B   B  B            B       B  BBB       
 B                B BB           B  BB  BB   BB   B   B     B  BB     B      BB    B  B  BB         B