       B  B   B   B     BB   B          B  B       B B    B    B    BB   B B  BB B B       BB  B   B 
    B      B B          BB    B B   BB         B         B      B      B     B BB        B    B   BB 
      B     B        B       B    BB     B  B         B       B   B B B     B  B    B       B        
B   B       B      B   B B BB B    B   B BB   B BB       B    B  B      BBB  B      BB    B     B  B 
B            B         BB B   B       B     BB      BB         B     B     BBBBB B B    B    B     BB
B B              BB      B   B         BB B       B     B            B        B        BB  B B   B B 
  B   B        B   BBB B   B     B    B     B     B                  B              BBB      B B     
B   B B    B B       B    B   B B  BB B     B  B    BB  B  B BB B B          B  B         BB        B
       B  B   B  B    B  B  BBB BB  B     B B           B                      B                B B  
  BB  B  B         BBB     B          B              B   B       B         B B        BB        B   B
B    BBBBB          B B  B            B BB          B                          BB B            BB   B
       B B             BB       B           B         B B                B       BB B         B    B 
     B           B          BB  BB     B B  B B            B    B   BB B  B       B     B   B    B   
      B         B         B B B   B    B    B     B  B        B       BB                     BB B    
   B BB   B     B B  B          B  B  B   B    B    B        B B   B B B  B   B B     B  B  B  B B   
B     B          BBB B   BB            B B           B  B  BB      B  B            B B B     BB    B 
                             B     B   B     B B  B   B            BB BB                   B BB     B
 B  B                   B B                 B  B       B       B      B B     B           BB        B
       B         B     B   B     B       B BB B       B BBB  B B    BBB B B          B     B   B B  B
    B B   B   B                 B B    B              BB    B   B     B B      B          B    B    B
   B                        B                    B B        B       B B B  BB    B   BB              
 B        B     B   B   B   B      B  B         B  B   B      B     B             B B    B    B      
      B                    B     B  B B     B   B B    B        B   B B BB    B   B   BBBB           
B   B    B       B   B B         B       B   B B   B    B     B   BB B  B    B       B    B  B    B  
   B        B B  B               B      B      B           B       BB   B               BB       B   
 B B                  B  B  BB B  B      B        B         B  BBB  B                B B BB     B  B 
   B       B            B            B  BB B                 B  B         B          B BB B  B       
 BB B  B B B  B   B    B B B   B B    B  B           B    B              B       B    B    B B      B
 B B  B  B      BBB B  BBB  B   B B B     B    B    B B BB       B     B   B B  B         B BB  B B  
    B         BB     B   B   BB B        B              B BB      B  BBB   B    B   B B  B   B     BB
 B B     BB B B    B  BB  B     B               B BB          B B       B BB   B          B    B     
      B      BB B         B  B      B           B   BB    B  B B B   B  BB   BB        B     B     B 
  B B  B   BB    B     B   B     B B  BB   B    B   B B       BB      B B    B  B  B  B  B           
  BB                   B     B B     B B      B   B         B     B  B   B B B  B  B B       B    B  
 B     BB     B   B                     B   B BB     B  B             B   B  B    B    B   B BB      
      B   B B        BBB B     B  B   B                           B     B       B  B          BB     
         BB    B                B      B        B              B B  B B BBB   BBB        B           
     B         B      B           B B    B    BBBBBB    B  B     BB  B                              B
    B     B      B     B        B B       B B    BBB B B  BB    B B B     B B BBBB B   B    B B  B   
BBB    B  B    B     B   B  B          B  BBB           B  BB      B      B  B  B B                  
B     BBBBBBB  B  B    B B            B    B      BB          B          B   BBB             B       
        B    B  B   B BB       B   BB B B  B B         B       B B  B          BB      B    B     B  
   BB    B B       B    B  B     BB      B  B  B BBB         B B          B B               B B    B 
B   BB    BBB          BB        B          B  BB      B      B B          B B  BBB B       B    B   
     BBB     B  B B      B  B       B   BB  BB B    B  B BBB                 B     B          BT     
          B    B  B   B        BB BB       B    B               B    BB  B B  BB B B  BB             
  B  B  B      B      BB BB  BB B B            B BB   BB    B        B      B   BB      B  B        B
             B  B        B       B    B       B  B  B      BB     B    B       B     B       B  B B  
BB    B B    B    BB  B  BB B     B        B      B BB                B B      B          B    B   B 
BB BB       B BB   B           B           B  B   B           B B   B        B        B    B     B   
 B  B             B     B B   BB    B  B B             B                          BB     B   B       
   BB        B  B     B   B    B   B     B    B B  BBB  B B            B            B        BB      
      B    B       B           B    B                       B  B                B   BB             B 
     BB B     BB B  B   B B                   B      B B B   B    BBB             B         B  B     
 B         BBB  B          B   B    B             B   BB B     B       B      BB  BBB       B   B    
   B   BBB B     B       BB  B            B          B      B    B B B B  B      B   B               
B  B      BB            B  B     B               BB     B              BBB B      B B   BBB   B B B B
    B       B      BBB    B B   B B       B B          B      B         BB B  B  B         B         
  B   B  B   BB    B    B B   B       BBB  B  B       B        B           B    B   B  B      B    B 
      BBBB         B     B  B BB  B              BB B      B B  B    B B       BB  B  BBB         B  
B              B      B   B B   B    B        B      B   B           B      B   B   B      B   B BB  
B                B B      B   B BBB              B   B   B   B B    B     B    B  B    B       B B   
 B               BB     B   B          B  B     B  B        B B  B   B   B           B   B           
B B  B            B B                      B    B B      B     B    B  B BB      B         B     BB  
 B    B                         BB    B                B      B      BBB           B      BB      B  
        B    B  B            B       B   BBB     BB B                 BB    B B   B  B B             
 BB          B    B    B              B BBB         B         B  B B B  B    B B            B      B 
B B  B B              B B       B       B        B BB  B     B               B   B  BB B  B    B B B 
        BB   BB          B           B   B              BB  B               B         B       B      
           B B     B      BB   B           B     B B   B B B B  B   B       B BBB  B BB  B  BB       
B       B     B   B  B   B B          B             B   B      B        B                   B        
   B B    B      B             B B BBBB            B  BB     B B           B  B    B    B BB    BB   
 B    B              B   B       B   B      BB B      B   B      B BBB B B B       B       B  B B    
  B      B      B    B        B   BB            B    B     B  BB   B   B  B         B    B  B B B   B
BBB B    B    BBB    BB B    B             B B      B    B B B      B       B BB B    B         B    
   B       B       B        B  B B    BB      BB B      B                    B  B   B          BB    
       B    B   B    B  B BB        B     B     B B      B    B  BB   B      B B        B B B B      
B  B B     B  B            B B B      B         B    B   B     B BB B             B      B  B     B  
 B B  B                         B B             BB B   B        B B         B    B B    B         B  
ABBB   B      B                          BB  B B     B       B    B    B   B  B         B BB  B  B   
  BBBBB  B B       B          B      BB BBB BBB              BB              B   B  B   BB B     B   
     B B             BB   B B  B    BBB          B B B                 B                         B   
     B        B     B  B  B    B          B          B       BB    BB B  B B       BB BB   B B    B  
       BB     B   B B     BB     B                               B   BB  B         B  BBB  B        B
     B       B           B BB      B     B B         B   B     B           B    B   B     B    BB    
  BBB    B       BB     BB        B         B   B   B          B  BB    B                         B  
B      B       B B    B              B                B      B     B      B   B        BBB    B B    
     B        B   B   B     B       B   B   B B          B         B  B   B B B     B     B       B  
 BB B B       B B                    BB         B          B  B       BB     B         B          B  
        BBBB    B            BB    B    BBB B           B  BBB B     B   BBBB      B               BB
            B    B B  BB BBB          B    B     B         B B   B B    B  B            B B        B 
    B B  B            B     B   B       B   B  B          B              B       BBBB     B    B   B 
B            B     BB B    B  B   B    B              B B  BB               B    BB      B           
         BB BB                    B      BBB B   B     B  B           B     B                     B  
 B              B    BB     B  B  BB   B   BB    B BB BB BB  B   B B   B B B    BB         B   B     
       BBB      B   B    B    B B    B       B   B    BB B    B BB B   B   BB B  B   B B B B        B
B  B      B                B        B   B   BB B BB  BB   B B  B     B          B      B            B
  B B B       B B  B   B    B         B B   BB   B        B  B  B   B   B       B       B        B   
          B B  B             B  BB B      B    B  B  BB  BB  BB   B            BBB    B         B    
B            B  B B                  BB   B    B  B       B B    B  B         B  B    BB    B      B 
             B  B   B    B      B        B     B B B           B     B B       B      B   B    B     