   B  B   B        B   B   B B   B       B  BB  BB    BBB    B      B           B  B  BB            B
            BBB    B  B  B B B  BB                     BB      B               BB      B             
B   B          B   B   B B   B   B            BB   B B           B B     B     B   B B   B     BB    
 BB B    B        B BB BB   B    BB      BBB BB   B           B  B           B B B      B BB   B     
      B    B B       B B      BB        B    B     BB      B                         B   B          B
     B B              B  B   B B   B     B   BB B   B                B  B      B B B                 
   BB B    BB B      B    BB       B BB  B          B   BB               B B       B    B            
B B   B  B  B     B     B  BB         B BB   B BB B BB  B    BB B    B      B       B    BB B   B B  
B      BB    B   B    B  B    BB B  B    B   B BB  B   B             B    B            B  B   BB   B 
 B   B BB       B    B BB    BB BB           B     B    B      B        BB  B    B B      B B  BBB BB
B      B  BB        B     BB BB     B B    B            B B   BB BB       B          B   BBB  B      
    B   B          B B      B B       B     B     BB   B     B        B   BB                 B BB B B
     B  B B    BB      B     B     B     B   B         B      B      BB    B      B      B  B    T   
B BB          B             BB BB    BBB BB            B B                  B  B        BB   B  B    
          B    B   B  B        B   B  BB  B B  B          B       B    B        B    B    B B  BB    
    B  B   B           B B  B        B  B    B             B    B         B   B  B BB B  B      B    
                     B  B   B   B    BBB         B        B   B   BB         B B       B  B  B       
   B  B  B  B    B  B B  B B       B       B           B    B    B      B B B                B   B   
 BB  B    B     B   B       B B B  B     B B B B   B       BBB      BB B B      B            B    B  
     B B  BB           BB B  BB     B B  B   B BBB  B       B   B    B    B B     BB  B      B       
    B     B   B  B           B         B    B B   B  BB B B  B              B  B         B          B
               BB   B          BB B              BBB     B B BBB  B           BB     B B  B          
   B      BB              B         B         B         B           B  B          B   B       B  BBB 
   B  B B B   B B  B  B  B  B           B  B    B       B  B        BBB B     B      BB B   B    B   
 B     B        B B      B   B      B            B B  B B                B   B         B B           
   B  B      B    BB   B        B     B        B B         B B B   B   BB  B   B   BBB    B BB   B   
BB    BBB B              B BB    B      B       B B  B   B B        B      B                 B     B 
B  B     BB             BBB  B B      BB          BB B      B B   BB B   B         B      B    B     
     B    B BBBB   BB   B   BB        BB     B     B B   B  BBBB             B   B     BB BB  BBB    
        B    BB               B    B       B    B  BB B        BB  B      B      BB         B        
B    B    B   B      B    BB  B   B      B   BB  BB B    B B    B      B          B   B B BB         
  B B   BB B B           BBB                   B                   B  B     B         B   BB B      B
    B    B B           B B       B B  B B   B      B        B       B  B      B       B B      BB B  
        B  BBB B        BB  BBB     B BBB    B       B   B     B     B  B    B         B             
      B BBBB    B     B  B        B   BB     B   B            B          BB  B  BB B B  B         B  
 BB   B    B           B                B          B  B      BBB B         B  B    B     B B  B  B  B
  BB  B   B           B   B B B      BB  B B  B B B    B      B      B B       B BB    B    BB     B 
B         B  BB     B         BBBB    B               B         B    B   B                 B  B      
 B    B       BB         B      B BB  BBB B    B               BB  B   B           B   B         B   
       BB    B     B       B         BB  B  B  BB B             B        B         B    BB B  B B    
B  B   B  B  B  B BBBB      B              B   BBB   B           BBB            B B BBB  B  B     B  
B  BB       B      B              BB   BB   B BB  B    BB     B     B     B   B B B               B  
B B BB  B BB BB     BBBB BB BBB B  B B  B    B  B      B BBB              B          B  B            
 B B      B B   B B B B B BB            B           B        B   B  B   B   BB                 B  B  
  B B   B        B BBB     B   B       B B     BB B     B    BB      B   BB   B    B      B  B      B
                BBBB B      B                      B        B B   B         BB           B          B
 B B    BBB BB B  B   B   B    BB   B B        B       B   B   BB    B B    B            B      B   B
B  B   B B B    B B     B    BBB   B BB B  B     B  B   B                       BB   B  B B          
      B   B B   B      B B  B      B    B  BB  B             B B B    B B  BB BB    B B        B    B
       B  B  BBBB BB  B B  BB   B     B    BB        B     B         B  B          B   B    B    B   
   B   B B           B      B B           B      B  B    B B B   B      B   B B          B     B     
BB B  B B                             B    BB  B            B       B                B B             
  B        B   B   BBB B     B        B BB B        B                                  B  B BB  B  B 
  B    B    B B         B   B         BB         B B      BB B B  B B    B BB  B B    B       B B  B 
 B  B     BB B  B                   B    BB B  B            B               B   BBBB B    B    B BB  
     B B   BBB      B             B       BB    B      B          B        B     B  B    B    B   B  
B  B       B   BB   BB  BB  B   B  B  B  BB    B   B     B      B   B B       B   BB B B    B        
 B    BB B  B   B     B    B B        B   B   BBB    B   B   B        B BB  B             B       B B
              B  BB  B         B        B    B B                                 B B         BBB  BB 
       BB     B    B  B BB  B B   B B         B BB                           B     B           B   B 
             B      B        B    B  B         B    B       B  B      B     B   B  B               B 
          BBBBB    B         B          B BB  B        B       B  B               B BB     BB       B
    BB      BB            B       B      BB                B   B         BB       B           B B B  
        B   BB   B  B         B       B   BB       B BBB   B   B B B  B  B B   BB  BBB      B  B     
   B            B B                  B B   B      B B     B         B       B      B B    BB   B B   
     B  B    B  B        BB      B  B       B B  B       B   B  B B BB      B            B  B B      
B BAB     B   BBB B    B B   B       B    B                  B  BBB                    BBB    BB     
  B  BB  B             B   B     B  B B  B      BB B    B      B B                    B B    B   BB  
B       B                 B    B  B  B              B  B    B     B         B B   B          B    B B
                       B    B       BB B   B        BB     BB B        B BB   B            B    BB   
 B   B   B B B B      BB     BB              B B      B  B        B  B       B     B       BBB   B B 
 B  B    B    B     B B     BB  B     B               B          B          B    B          B      B 
 B      B      B  B          B     B B    B  B        B      B        BB B B      B             BB   
     B          B B  B      B      B  B    B   B      B B BBB   B             B B      B             
B          B          B  BB   BB     B B      B  B                    B        BB       B B       B  
   B       B     BB BBB B B B           B   B     B       B B        B       B B                     
      B    B B B  B  B  B  B    B  B   BB      B       B       BBBB        BB  B        BBB   B      
 BBB B B B    BB    B B    B B B      B  B      B      B         B B B B      B               B      
         B B     B   BB             BB BB     B B BB B B  B       B   B          B B       BB   B  B 
        B        BB BB    B             B   BB    B   B         BB  B        B     B                 
B    B   B  BB        B B B B       B    B    B      B   B B  B   BB B B  B                        BB
               B        B B              B     B   BB       B     B        B BB  BB      B    BB    B
B          BB        BB BBB  B B     BB       B   B       B B BB    B                 B B      B    B
   B   BB B   B   B          B  B    B      B  BB   B           B          B      BB                 
                B    B                  B  B     B    BB       B   B   B  B       B      B     B     
           B      B B  B B             BB B B       B B                   B    B B       B B  B      
                   B    B         B     B        B     B   B               B        B B  BB  B BB    
                     B  B B         B  B  B         BB BB         B                  B     BB        
 B           B    B BB     B   B          BB  B   BB    B  B BB                          B     BB    
 B B  B    B     B          B         B B  B             B   B    BB B  B      B        B  B         
   B B      B           B   BBB   B B      B   B     B B    B     B B B             B      B       B 
    B BB     B        B   BBB       B         B        B  B     B  B     B B  BB B B    B  B  B      
      B B       BB                    B B     B B  B   B B          B B   B        B B    B  B      B
   B   BB BB            B      B       B          B          B   B BB              B  B B    B     BB
B   B       B   B   B B                                B    B     B    B  B   B  BB  BBB B B   B  B  
   BB          B  B    BBB      B  BB   B     B     B    B  B    B    B   B B      BB    BB       B  
  B    B   BB   B  B B                B   B B B          B   BB           B  BB               BBBB   
                      B      B             BB  B B  B B B     B  BB BB    B BBB         B      B     
     BB        BB     B BB      B           B       B    B  B   BB  B  B  BB        B   B          B 
      B           BBB  B     BBB  B   B B   B               B B    B  B   B      B   B               
 B            B   B  B B  B  B   B     B   B      B BB B   B   B     B  BB    B          B  BB   B   