 B           BBB      BB   BB    B             B  B   B    B        BB            B    B      B      
B           B            B         B  BB B   B     B      B  B             B      B   BB        B    
        BB     B     B    B  B     B  B   B        BB    B  B  B     B       B   B  B B      B       
               B          B    B B    B    B  B     B  B       B       BB           B   B B        B 
   B B     BB    B  B B   BB B  B  BBBBBB       B   B    B      B B    B BB B                 B  B   
        BB     B              B         B    B     B    B     B B           B  BB       B         T  
    B    BB                B   B    B       B  B     B  B   B        B         B B      BB B   B     
B  B B        B B  BB    B  B     B   B   BBB    B  B BB B           B    BB  B      B  B B B  B   B 
     BB  B     B          B BB        B    B    B           BB    BB B           BB     B   B   B    
      B                B BB   B   B       BB           B         B    B  BB   B           B        B 
             B B B B     B       B   B           B B  B   B         BB     B B          B            
      B B    BB BB B    BB         B  BBB  B BB    B   B B  BBB    B  B   B   BB  BB  B        BBB B 
 B    B    BB     B     B        B         B   B     B               BB  B   B   B  B       B B      
  BB     B B        B     B    B   B  B    B      B       BBB      B            B     BB        B B  
 B    B     BB    B  B BB  BBBB     B B   B   B    B   BB B  B              B B         B            
    B            BB BB  B  B B B     B      B                      B         BBB              B B    
 B     BBB        BB B B B   BB      B  B B       BB B  B B   B B            BB        B    BB  B BB 
        BB B     B B       B  B  B     B   B B        BB B      BB   B        B   B     BB B      B  
    BB B  B  B           B                   B B               B B    B        B        B       B B  
   B        BB     BBB    B B  B  B   B   B    BB    B      B BB    B        B BB   B      B  B    B 
  B   B    B      B B B B  B     B     B      B           B            B     B           B    B  B   
   BBB  BB              B     B  B       B              B B  B    BBB      BB                 B  B   
 B                          BB      B      B B B  B          B    B   B              B     B         
  B  B B   B       B    B   B BB         B B B          B       B   B  BBB   B     BB  B   B B       
      B          BB      BB                      B BB    B BB     B    B B    B B               B    
  B              BB  B  B    B B  B    B           B B        B         B  B B   B BB B   B          
 B   B B  B  B B  B B  B  B            BB                      B B B   B      B   B         B        
 B       B   B  BB   B                        BBBB    BB   B   B B     B B    BBBB     BB   BB       
               B   B BB B      B B       B B       B      BB       BB      B  B B    B  B     B    BB
             B BB        B B               B B B B B   B      B   B       B  B    BB   B      B      
      B B B         B  B B   B   B   BB B   B    B      B      B       BB BB  B       BB          B  
 B  B  B         B     B      B  B        B      B    B      BBBBBBBBBB     BB  B                    
  BB  BB  B    BB       B        B  B  B B   B B             BB B    BB  B B                 BB      
      BB  B    BB               BB      B     BB      BB    B  B      B           BB        B        
 BB           B  BB B B B   B      B   B    B       B BB B                  B        BB         BBB  
        B   B B  B BB   B    BBB       B  B       BB            B   B BB BBB B  B  B   BB            
   B  B     B   B                B        B       B   B            BB B                 B            
         B B     B B  B  B        B  B   B       B        B                     B                B  B
             B     B B  B                        B B  B  B    B    B  BB      BB      B  B      B    
         B       B BBB  B     B  B B  B      BB     B          B    B B B        B          B        
 B BB   B  B   B B B B  BB   B      B  B B  B   B  B        B       B  BBB   B       B      B  BB    
   B  B  B          B   B          B    B       BB      B  B                 B    B     B B  B       
     B   BB B          B       B              B    B             B       B        B B    B  B        
       BB      B B    B               B  B         B          B B B      B           B    BB        B
    B  B      B                   B     B              BBB  B      B       B           B      B      
 B          B B          B         B        BB    B B              B  B  B B  B      B      B  BB    
    B B B     BBB             B  B  B B       B B       BB   B   B   B    B     B         B  B   B   
 BB  B          B   B   B B      B   BB    B B    B  B  BBB    B   B       B       B   B    B B      
  B   B  B  B  B       B   B               B   B   B B  B    B                  BB  B  B             
            BB B B B  B    B   B  B                 BBB B     B  B  B BB        B     B  BB     B  B 
 BB  B B        B   B BBB   B          B  B       B   B         B    B       B         B        BB B 
 BB      B BB            BB B            B  BBBB    BB   B B  B           B                      B B 
     B    BB   B           B   B B B       B B               B            B    B                B    
           B       B    BB  B BBB           B     B B  B   B        BBB         B           B B B    
       B     BB        B        B  B   B      BB                  B BB        BB           B B  B   B
       B  B         B B        B    B BB B    BB   B   B         B BB       B           B       BB B 
  B            B B    B                  B     BB      BBB B    B    B  B B      B  BB         B   B 
 BBB  BB       BB   B     B B B       B      B  BBB      BBB   BB                     B  B B         
   B   BB    B B     B   B B  B        B                   B     BB B B     B  B           B    B  B 
   B  B B     B B B   B      B         B    B        B     B        B    B      B   B        B     B 
  B    BBB B               B    B  B          B BB         B B          B       B            B       
B    B  B           B        B        B B         B   B     B BB B              B   BB    B      BBBB
         B   B     B   B  B     B                                         B      B             B     
                 B    B B    B           B               B       B     B BB BB B B    B      B  B    
 B  B   B     B     B B         B     B    B  B B           B    BB  B          B B   B B          B 
  B  B      B  B  B      B       BB B  B  BBB         B B           B    BBB    B    B B  B BB B     
       BB  B     B      BB                    B B  B B           B   B BB  B    B BB   B B          B
BB   B   B    B   B B    BB B    BB       BB   B     B    BB    B    BB       B B               B   B
B    BB           B            B       BBB        BB   B     B      B   B       B B       BB        B
   B B B                 B     B     B    B                  B             B  B   B  B     BB   B  B 
B    B   B        B     B B        B    BB BBB   B        B                     B    BB B B          
B       B           B BB B  BB    B     B     B  BB  B  B   B                     BB        B  B     
B  BB     B    B    B  B         B   B    B    B BB BBB BB          B                 B B         B  
   B B       BB       B                 B  B             B  B B    B  BB    B B  B B             B   
   B  B     B        B B B    B   B     B      B  B    B   B  B B  B      BB   B  B  B               
              B  B            BB B     B    BB B    B                            BB      B    B  B   
 B  B  B  B       B    B       B   B       B   B   B           B B    B          B                   
         BB B  B     B BB   B B   B  B   B              B  B   B  B  BB B   B  B               B  B  
    A                       B  B     BB                         B   B          BB BB  B B       B    
  BB     B     B    B      B     B         B    B  BB    B    B        BBB          BBB          B  B
    B  B  BB    B      B    B        B               B      B       B  B      B           B      B   
    B  B B       B      BBB                 B   BB B   BB  B         B               B  B     B     B
   B       B  BB  B     B B B BB     B   B        BB BB B B     B           B     B          B  B    
       B         B  B       BB   BB B    B         B      B                B B    B   B         B B  
   B     B BB B             B       B     B     B  BBB B B   B  B B    B      B  B     B B         B 
     B  B     B B   B                      B    BB B  B  B       B    B    B    B      BB        B  B
             B   B        B      B    B  BB         B  B        B      B   B    B  B B               
    B  B B B            B B B   BB  B   B  B   BB    B    B       BBB     B   B B BBB    BB B   B    
      B    B            B     B       B              B     B B        B   B   B  B  BBBB    B  BBB BB
 BB                B B          BBB  B B                 B     BBB BB       B     B BB          B  B 
 B       BB                        B B      BB  B  B  B B  B    BB BBB  B    B B B B       B       B 
     B B                 B   B     BB  B    B              B    B          BB         B  BBB       B 
              B         B    B     B   B   B      B BB B     B   B B BB B  B   B      B      B       
     B     B                    B   B B  B      BBB  B BB     BBB     B  B   B  B    B     B B B     
 BBB            B  B        BB B    B                B                      B         B         B  B 
 BB  B      B     B B         B       B B          BB      BB    B B     B                 B     B   
    B        B B      BB           B     B B B  B      B              BB      B     B B              
   B            B    B    B   B     B      B    B          BB  B    B                 BB   B   B  B B
B           B     B    B               BB BB      B   B  BB BB     BB     B      B        B       B  
            BB  BB     B   B      BBB   B         B   B BBB  B        B B     B    B B BB   B        
 BB     B  B    B  B   B  BB B     BB B       B    BB B B   BB        B       B     B   B  BBBBB     