   BB   BB   B   B    B     B        B B   B               B  BB   B  B  B   B   B               B B 
             B  BB  B  BBB           B     B B      B         B  B   B         B B      B  BB      B 
       B          B     B     B B BB B     B   B   B  B   B   B    BB      B        BB       BB    B 
B B  B  B    B  B    B         B   B   BB    B       B B  B      B BB      B B B    B         B      
 B     BB    B   B    B   B    B    B  B      B    B      B  B             B    B B  B         B  B  
   B  B      B         B    B        BB       B       BB    B   B B BB            B    BB BB B BB    
 B  B            B    B BB  B B    B BB BB                B  BBB  B BB     B B    B B B B      B  B B
                  B     B      B   B B   B      B                    B           B    B  BB   BB T B 
 B B             B                B     B     B  B    BB  B    BB    B   B      B     BB B  B     B  
 B  B  B  B   B         B        B    B   B              B        B BB   B   BB   B           B    B 
B      B  B    BB  B     B B  B  BBBB      B              B B    BB      B    B B B     B    B       
   BB   BB      B  BB   B         BB                    B     BB BB B     B  B    BBB    B           
B   B       B   B   B       B     B          B      B  B  B  B B                           B     B   
B B B      BBB       BBBBB           B   B B  B     BBB BB  B      BB  BB  BB B  B B B  B  BB    B   
 B  B  B    B               B  B       B       B B B B       B   B B     B      B    B      B   B B  
B     B     B  B     B                   B B   B    B  B    BBBB     BB  BB  BB   B  BB     B B     B
              B     B   B   B  B  B    B         B     BB    B       B   B   B      B   BB           
    BB     B  BB      B  B   BB  B      B       B   B     B   BB BB     B    B BB       B    B B    B
 B  B B                B  BBB B BB  BB          B  B  B B BB   BB          B BB     BBB   BB         
                B     B    B    B      B     B   B   B     B   B  B               B      B        B  
   B             BB   B   B    B      B       B            B   BB B  B    B     B B  B   B  B B     B
          B      B   BB B   B  B   B        BB   B   B       BB                        BB        BB  
                   B  BB   BB      B               B              B         B        B    B  B B  B  
    B            B B B       B B  B           B    B B  B BB           B  B     B    B      B B     B
 B     B         B             BB                 B       B B   BB     B  B  B    B        BBB      B
    B     B             B           B  B   B   B  BB    B           B B B         BBB   B B          
B   B         B  B  B  BB   BB     B       B           BBBB      B           B B    B B     B  B B   
B     B B  BB   B B   B BB            B  BB  B       B  B        B  B  B    B    B     B  B   B      
  B      B BB    B   B B     B   B         B   B  B                   B  B   BB   B     B BB         
      B   B          B B             B     BB  B             B     B  B            BB        B B   B 
 B  B  B  B  B      B B   B      B                 B   B                  B B        B   B  B     B  
   B       B  B  B      B         B   B B B  BB            B B        B  B B B B   B     B    B      
 B B         B  B B     B B         B   BB     B           BB B B         BB B    BB       B   B B   
B       B   BB     BB     B       B      B  B BBBB    B              B    B          B        BB  B  
B    B   B       B  B        BB  B         B   B             BB    BB     BB        B   B   B        
 B             B    B     B           B    B   B    BB    BB  B B    B      B   B  B  B BB B         
 B  B      B         B       B        B  B  B         B             BB   B       BBB    B B B B BB  B
    B     BB           B            B   BB   B   B  B B BB         B  B    B   B             B  B BB 
  B         B    B   B  BB B         B              B BB  B      B    B  B  B   BB    BB             
B         B      B  B   B B   BBB           BB         B  B   B B  B     B      B      B  B   B B  B 
        B B  B B B   BB     B  B   B               BBB B              B BB   B         B     B  B B  
B  B   BB     B     B   BBB   B B BB B                    B       B         B           B B   BB  B  
          B    B  B    BB      BB   B B        B  B B        B       B     B  BB  B      B         B 
    B      B   B   B    B   B        B          B   B             B    B B  B       BB             BB
              B  B               B    BB B     BB        B  B BB BB    B B  B             BB    B  BB
  B        B  BB      BB  BB  BBBB         B   B   B   B    B   B        B    B B  B   B             
             B  B B     BB     B  B       BB   B    B  B        B          B  B    B    B  B         
       B  B           BB   B        BB   B B  B B  B      B    B  BB      B          B     BB        
        B    B  BB             BB          B      B   B     B B              B        B         B B  
      B B   B      B      B  BB    B       BBB      B        B B        B     B B   B          BB  B 
             B B     B   BBB B  B    BB    B  BB  B B          B     B  B       B       B   B  B   B 
    B  B       B           B BB B B   B  B  B  B            B  B  B      B     B                  B  
  A          B    B  B   B             BB                 B  BB    B   B B B   BB B      B B    B    
      B  B       BB   B  B B B  BB  BBBB    B   BB       B    B B         B     B      B    B B    BB
BB                     B                B   B   B  B BB        B    B    BB     B       B B BB  B   B
                  B  B    B         BBB   B     B       B B         B   B        B  B   B        B  B
     B           B B   B          B                B  B      B  BB          B  B           B  B B    
B B  B  BB     B B    B  B    B  B     BB   B B B             B    B                B   B            
B   B      B     B BB   B     B          B            BB   B                   B          B      B   
     B   B            B          B    BB   B   B     B  B           B      B  B                      
             B BB  B    B                B    B   B      B B  B       BB      B  BB    BB   B      B 
   BB    B      B           B         B      B    BB B           BB      B     B         B   B B    B
B  BB B B BBB  B   B    B   BB    B          B    B   B      B                BB  B              B   
   B   B    B     BB       BB         BB          B B    B  B B   B      B    B  B    B B    B    B  
  B           B    B     BBB          BB          B      B B  B        B          B   B   B       B  
             B         BB BBB     B B B    B    B       BB  BB BB  B   B B                           
 B BB                       B  B    B  B  B  BB  B    B       B      B    B   BB     B               
  BB   B         B  B  B  B  B B        B   BB B  B       B      B      B  B B      B     B   B      
            B        B          B            B   B         B  B        B    B  B       BB B  B  B   B
 B B               B              B              B    B      B BB    B          B   B  B      B    B 
BB      B         B B       B    B            B  B  BB               BB          BB        B         
  BB    B        B          B        B  B       B   B        B        BBBB        B B   BBB  B       
          B        BB B          B     B B    B                   B  B  BB            B  BB     B B  
       B B        B         B  B    B     B  B         B   B         B   B    B  B                   
B B                  B B     B B         BB                B    B B   B   B  B     BBB B     B       
    B B      BBB B      B    B B  B      BB     B       BB       B        B   B B B B B  B         BB
     BBB     BB    B     BB                   B   B    B    B  B     BB  B B   B B   B   B   B  B  B 
       BB B                  B         BBB           BB        BB      B   B          B   B   B  B  B
  BBB  B       B B B      B B B       BB     B B                          B  B   BB         B B      
    BB      BBB   BBB BBB B   BB BB      B                 BB  B    B     B    B    B  B      B   B  
B BB  BB  B B     B          B   B         B                      B    B        B B      BBB        B
   B      B  B       B            B     B      B B B     B B          BB B  B B       BB     B    BBB
   B  BB  BBBB                              B        B    B  B B B   BB      BB  B     BB B  B       
   B   B  B  B B    B B              B  B       B  B         B B B   B  BB  B      B     B B         
 BB   BB      BB      BBB B    B               B  B   B  B          BB          B   B              B 
    B      B    B B  BB B        B  BB        B B B  B B                              B      BB     B
    B       B        B  B  B      B    BBB   B        B  B               B   B   BB    BB   B  B     
             B  B        B   BB B   B B B    B   B BB  B B   B B    B        B BB             B B  B 
    B  BB B      B   BB  B    B         B        B      BB B     B                       B B     B  B
        BBB             B       B     B    B   BB  B          B  BB B B   B      B BB   B  BBB       
  B  B    B              B B   B B      B             B         B      B      B      B      B  B B  B
  B              B    B  B         B      B           BB   BB  B   B       B     B  B BBB    BB      
          B B BB  B      B         B   B BB  B            BB        B   B  B B       B             B 
      B      B   B B     B         B B     BBB    B B       BB B   B   B B       B  BB    B      BBB 
  B       B B      B    B      B B      B              B              B     B    B  B BB            B
        B  B  BB B             B   B   B        B B                        B  B BB B     B   B       
          BB     BBB   B          B      BB B         B      B           BB B    BB           B    B 
 B           B    B B  BB B  B B  B B    B      BB         B       BB       B B  B                   
      B  BBB   B  B    BB  BB   BB   B  B B B   B B       B     B                              B    B
B                     B  B               B    B       B   B    B         B    B          B  B  B BB  
 BBB  B                 B                           B         B      BBB  B                          