   BBBB   B   B BB           B    BB B         B                 BB  BB            BB B  B  B        
 B  B  B    B        B      B   B  B    B   BBB    BB   B  B     BB B  B       B B    BB  B     BB   
 B  B B      BB    B      B  B  B  B        B   BBB         B     B  B   BB            B  BB         
    B          B B        B  BB      B         B    B     B           B       B          B       BB  
          B B     B   B    B  B   B  BB   B      BB B   B  B    B         B      B B    B  B     B   
      B           B  BB B   B        B         B    B  B   B    B   B  B   B      B BB        B      
  B B  B       B       B     BB  B B      B B   BB      B  B   B B  B  B      B B       B          B 
              B   B    B  BB B  B               B                B  B         B   BB       B      B  
 B  B     BB B  B     B B           B    B B            B     B   B      B  B        B       B       
 B                   B   B  B   B       B B     B             BB   B B       B    B    B      B B B  
     B  B   B    B    B  B  B B  B   B  B  B B B B    B   B         B     B                B B BB B  
                         B                    B B            B       B   B    B      BB       BB     
   B        B B       BBBB    B   B  BBB           BB       BBB      B  B  B B        B  B  B    B   
   B   B     B  B        B B      B        B B       B  B         B    B B B                B        
   BB             BB    B  B   B B    B     B      BB B   B B    B       B       B   B B     B      B
       B    B B  B           BB B            B BB          B             B  B  B     B       B    B  
     B  B  B B             B  B  B    B        BB B                BB  B    B B    B BB       B    B 
     B BB  B                 BB  B   B  B    B B            B  B     B BBB             B          B  
               B B    B        B  B    B B    B    B    B      BB  B             B      B B          
B        B                    B    BB  BB B  B          BB   B       B         B            B   B  BB
 BB  BB  BB                       B             B                    B     B     B        B        B 
       B  B     B           BB  B  B       B B      B B          BB    B     B B   BB                
            B       B     B    B  B  B   B   B     B      B    B     B   B  BB  B B                  
     B BBB    B BB     B  B   B  B      B  B                BB BBB   B       B                B    B 
B  B    BB BB    B           B  B                     BB      B         BB   B    B BB  B B B    B   
            B       B       B         B B      B          B  B                  B   B      B        B
B     B    B BB B B     B  BBBB B    B   B   B    B        BBB     B BB   B               B  B       
        BB  BB      B B B            B    B           BB    B            B   B  B   B   B   B  B B   
   B      B B   B B  B        B B       B         BB B  B B    B     B BBB  B    B B            B    
 BB BB        B       B            B                BB          BB B B            BB B             B 
   B        BB   B        B   B     B     B B   BB B     B        B  B  B   B       B     B     BB  B
   B     B  BB      B        B   B     B  B         B B  B B    B     B      B     B   B   B      B  
       B     B    B   BB       B         B B   B B   BB  B                 B      BB  B       B  B   
B  BB  B B B   B             B            B  B             BB              BB   B        BB  B  B    
  B     B   BB    B        BB B      B        B     B B B        B    B      B B       B             
                   B          B   B  B   B      B  B          B   B    B     B    B    BB BB   B     
      B    B B      B   B    B  B   B   B     BB   B         B       B    B B       B          B   BB
    B B   B            B         BBB    BB     B                        BBB   B B    B      B  B B   
        B           B              B B    BB       B          B   B BB     B B                B   B  
        B      B   B B BB B     B   B  B           B       B   B   BB        B          B   B BT    B
     B        B  BB     B  B  B  BB           B   B   B B BB   B    B BB  B             B            
       B   B B         BB B    B  BB   B B       B   B                 B B  B    B  B  B        BB  B
 B                   B B                  BB    BBBBB   B            BB  B                 B BB     B
    B  B    B   B B  B  B              B                         B   B B    B   B    BB       B    B 
BB B   B       B    B       B B B B        B         B  BB BB    B   B          BB    B     B    B   
 B           B   B B     B  BB BB      BB         B                  B                     B       B 
B     B  B        B  B      BB  B                B       B    B                  B      B     B      
 B    BB  B     B B       B B        B  B B           BB B           B  BB    B           B     B   B
      BBB  B  B  B   B B B    B BB       B B B              B B   BB B  B B   B  B BB BB   BBB B B   
        BB B       B   BB B B   B    B        B BB B                B       B    B   B    B   BB     
B                     B        B   B         BBB                 B  B            B BB B              
B              B BB    BB    BB   B  BBB     B    B      B     B           B   B      B      B     B 
BB        B        B        B        B    B         B     B BB     B    B   B     BB B             B 
     B  BB  B  B    B  B       B B  B    B B  B    B        BB      BB     B    B    B            BB 
   B BBB       B      B     BB  BBBB     B        B      B          B         B     B   BB        B B
 B B          B               B B        B      B                    B   BB     B  B  B  B   BB    B 
     B      B BBB B     B         B B  B      B   B BBB B   B      B        B    B     B     B    B B
 BBB     BBB B B BB             B     BBB      BB  B B BB B         B      B   B    B           B    
 BB   B  B    B       BB    B  B  B  B  BB    B     B BBB B                 B B  B   B  BB         B 
 B       B   B             B     B       B     B BBBB     B             BB          B B   B   B B    
  BB   B        B     B        BBB          BB B   B   B     B          B B B     BBB BB   B BB B    
 B   A  B        B    B  BB    B   B        B          B        B    B B  BB           B  B B      BB
    B   B    BB   B            BBB    B    B  B              B       B     B            BBB        B 
B       B B BB            B   B        B   BB   BB        B  B   BB    B    BB B     B               
    B    B          BB   B B        B         B    B  B        B    BBB  B  B      B     B           
                B      B     B B  B B   B  B           BB           BB      B    BB            B     
           BBB  B     BB          B      B B B  BB  B   B BB      B   B  B        BB B BB  B  B     B
            B B    BBB      B B B B      BB  B         B  B     B  B    BB  B      B B   BB B        
   B B   B         B         B      B    BB         B    B B                          B         B  B 
     B B      B       B BB            B B     B      B      B    B      BBB            BB B     BB  B
     BB    B            B B                B  B      BBB B B B      B       BB  B    B     B  B  B   
B  B       B  BB    B     B   B       B       B   B         B B BB      B        B      BBB    B     
     BB BB  B      BB  BB      B     B  BBB B        BB       B  B       B   BB    B         B  B    
   B     B                B      B   B                 B    B        BBBB    B  B B B   B            
 B       B                 BBB B B    B     BB            B      B               BB              B   
    BB      B          B  B B B BBBBB              B   B       B BB BB  B B    B B  B     BB B   BB  
BB   BB  B   B   B            B   B  B   B        B       B  B B    B B  BBB  B     B     B B        
B B               B B                     B     B          B B   B  BB     B  B           B        B 
     B     B           B      BBB B  BBB            B   B   B      B   BB  B  BBB      BBB  B    B   
 B B  B    BB           B                      B   B           B  B  B    B  B   B   B    B B B     B
    B           BBBB       B B   B B   B B   B          BB BB    B        BB      B  B       B   B   
 BB        B      B  B BB        B   B             B  B       BB    B                B    B BBB B    
      BB  B      BB                             B  B   BB              B              B            B 
   B             BB    B B  BB B B   B           B    B      B B  B      B BB   B   BB  B   B  BB   B
B    B             B  B B                 B B B B B      B  B  BB   B       B       B         B  B   
    B  B   B     B     B   B  BB   BB              B B  BB       B         B  B  B  B    B        B B
      B      B     B     B         BB BB   B   B           BB B B        B    B    B     B      B    
   BB     B      B B B         B  B   B  B  BB  B     BB        BBB    BB    BB B       B    B B     
   B B B  B    B           B B B  B      B       BB B     BB B    B BBB B    BB                  B   
    B               BB       B   B     B      B                   BB                    BB         B 
 B        B               B  B         BB  B                    B B     B B      B B  B          B   
  B     B B  BB              B             B   B   B     B      B         B B         B   B   B   B  
   B  B     BB  B B        B      B  B      B     B B     B            B       BB           B  B   BB
 B    BB    BB    B  B  BB  BB  B  B  B      BB          BB  B           B       B  B   B       B    
B     B   B   B B    B          B B   B                 B   B    B B  B   B     B  B         B B     
  B     BB    B   BBB  B   BB    B    B     B   B       B  BB    BB  B  B     B  BBB  B  BBB B B     
    B          B   B    B             B    B              B   B  B   B B  B BBB         B BB B   BBB 
    BBB     BB  B                      B   B        B        B       B       B       B  B        BB  
B B   B     B             B          B    B            BB    B B             BB                 B  B 
    B B B   B BB B      B                 B      B    B             B      B   BBB   BB      B       
      BB      B B B        BB B B      B    B           B        B B  B    B B  B          B BB   B  