  B  B          B    B                       B   B  B      B             BB    BB     B  B        BB 
     BB   B         B     B     B             BB    B        B    B          B          B      B     
    B    BB         B   B       B  BB B  B     B               BB   B      B  BBB  B   B   B B      B
     BB          B B          B B B   BB   B B B       B    B B     BB          B       B  B      B  
        B         B BB    B  B  B  B      B    B B BB       BBBB  BB B   B        B B     B  BB   B B
     BB BB       B B B B     B    B  B              B    B    B         B B  BB B             B  BB  
  B       BB     B  B       B              B BB      B        B B         B BB B         BB  B       
    B      B    B   B    BB B   BB  B       B      B B                      B  BB                    
B       B       B  BB   B         B     B B   B  BB  B B           B B     B      B B  B B B     B  B
 B   B B                  BBB        B B   B   B             BB        B                B            
            B B    B   B BB  B     B    BB        B B B     B B   B    B   BBB       B      B     B  
 BB      B    BB   B    B      BB                B  B BB B B B                     B BB  B B   BB  B 
    B  BB      B       B B    B      B      B       BB   B   B  B       B  B          BBB   B    B   
         B  BBB          BB       B      B   B                      B  B   B  B              BB   B  
  BB B   B    B  B B BB    B       B  B B     B                BB  B          B       BBBBBB      B B
  B     B   B     B        B B B             B           B   B  B  B       BBB                B B BBB
     B         B    B              B     BB      B       B B      B  B    B    BB   B   BBB B   B    
  B B   B       B B    B                 B BBBB                B BB B              B B BB      B    B
BB     B        BB            BB              B   B B B       B BB         B      B  B B    B        
             BB             B  B B           BB      B  B  B B   BB        B      B      B    B  B   
 B          BB        BBB   B B B BB B   B         B             B B  B           B    BB        B B 
B             BB B BB B    B  BB     B  B     B          B       B       B   B     B BB   B   B  BB  
   B             B B   BB  BB        B B BB B     B      B       BB  B   B           B B            B
      B    BB   B        B      B     B B    B       BBB  B     BB           BB B  B      BBB B B    
B B            B         B  B   B             B BB B B       BB    B B   BB  B  B B   B          B   
      BBB     B  B          BB     B  BB B B B  B     B B B            B B  B      B B           B B 
   B BB   B     BBB        B   B    B   B       BB B         B B    B      B  B         B       BB   
               B  BB  B   B  BBB B B    B B       B   B                     B        B   B       B   
  BB B  B   B         B B BBB B     B   BB B     B  B    B         B B B        B    B    B         B
       BB   B B  B BB        B  BB  B BB    B    B   B   B      BBB   B BB B       BB B   BB B   B   
  B  BB    B                    B           B      B       B BB   B       BB           B           B 
   B         B  B       BB  B    B      B            B  B         B B  B    BB   B BB  B   BB      BB
                   B  B    B      B         B    B B B  B          BB     B B B B               B    
 BB         B B     B   BB          B B  B B          B    B            B      B B      B       B    
B       B           B               B B   B  BB   B   B     B  B B       BB    B         B   B       
           B     BB  BB  B B   B B   B B  B   BB         BB       B    B BB      B B  B            B 
 B  B   B         B BB  B              B B B     B      B   BB BBB      B B   B            B B       
      BBBB      B         B   B   B B       B     B  B B B    B     B          B   B B  B B  B    B  
  B  B        B   B                 B     B   BB   B    B     B BB BB      B    B   B     BB  B      
  B  B          B   B  BB B   B       BB  B  B         B    B BBB       B       B B   B    BB    B   
                        B      B B B B  B  B        B B        B  BBB           BB   BB       BB     
     B B  B  B B     BB   BB  BB   B B      B   B B B B          B BB  B    B     BB     B   B       
BB        B B           B B          B   BBB B       B       B B   BB B BBB B B          B  B        
B           B BB   B              B            BBBB  B B               B          B   BB             
B            B   BB  B B  B B B   B    B         B  BB     B   B    BB   B              B        B   
  B B    B  B     B    B           B  BB      BBB B    B B            B BB   B      B B B            
B    B   B BB   B B       B  B  B  BBB    B         B           BB        B       B      B   B B B  B
BBBBB    B  B B   B    B  B      B B    B B   BBB      B B         B     B   BB  B       B   B   B   
    BBB           BB  B   B       B    B       B    B         BB    B    BB    B BB B             B  
B      B B  B                  BBB BBB        B     BB  B       B    B B  B      B     B  B    BT   B
   B BB  B    BB B                          BB               BB   B B   BB          BB   B B    BB   
            B  BBB         B  B B       B  B    BB B        B  B   B   B     BB      B      B B B    
  B  B       B B           B     BBB    B                  B B  B       B               B    B       
B  B      B      B      B   B     BB     B      BB           BB    B       B BB    B     B  B  B B BB
B    B B                   B B    B B    BB BB         B       B       B  B B     B   B B B  B     B 
     BBB          B               B B    B  B B B B     B     B          BB  B    B B      B   B   B 
     B   BB     B     B   B  BB    BBB  B   B        B   BB          B B      B           B BB      B
B            B B     B  BBB B        B  B  B        B B       BB B       B  BB              B     BBB
       B B B           B    BB  B B  BBB       B B     B  BB  B       B B          B    B        B   
  B B     B           B  BB      B BBB            B  B             BB   BBB     BBB           B     B
  B      B  B   B    B  B      B    B B   B  B    B          B       B   B  B      B   B     B    BB 
          BB B  BB   B   B       BB B      B    B B           B     B      BB      B   B   B BB  B  B
B                   B    B B B            BB B       B  BB  B            B B     B  BBB    B      BB 
    B    B   B    B  B         BBB B    B  BB  B    B     B  BB      BB B  B     B    B B  B B       
 B     B  B            B  B      B             B     B B    B B        B   B      B   BBB  B      B  
BB BB B    B          B              BB B      BB   B           B  B      B B   B  B B     B      B  
   B   B   B   B        B       B      B           B B   B                   B B  B B  B  B         B
        BBB         BB          B B   B     B    B   B  B   B  B    B        B    BB       B  BB   B 
B        B         B         B B    B    B            B                   B    B      B B     B     B
    B B  BB B      B         B  B    B     BB    B   BBB    B BB   B B       B        B   B  B   B  B
  B  BB     B     B  B BB                               BBBB BB     B         B  B B   BB       B    
  B     B     B  BB   B      B   BB    B     B      BBB    B   B    B                     B B BB BBB 
B            B B      B B          BB      B BB    B            B  B   B     B     BBBB B   BB B  B  
       B   B                   B         BBB    B  B B      B            B     B B     B        B   B
 B B      BB      BB   B     B         BB    B   B  B             BB                 B   B      B B  
          B    B   B                           B            B   B   B            B        BB   B     
       B   B      B         BB   B         B    BBB       BBBBB  B  BB    B    B   B       B     B   
 B B  B  B     B       BB             B       B  B B  B         B             BB  B  B B         B   
  B    BB    B       B   B   BB B    B        B   BB B B             BB   B    B              B      
B    B   B   B B   B         B     B              B     BBB B B  B  BB              B    B    BB B   
       B B   BB    BBB        B   B       BBB  B     B          B     BB  B        B   BB  BB   B    
 B  A      B    B     B    B B BB   BB   B     BB   B  B   BB  B BB          BBB BB       B    B  BBB
      BB    B   B      B   B  B B                B    B       BB      B     B   B B   B  B           
  B BB     BB    BB   B                  B    B   B          B                 B  B                B 
         BB B    B B  B   B  B               B  B   B        B       BB        BB BB B    B    B     
     B   BB         B BBB           B B B       B      B     B    B  B        BB     B  B            
 B  BB    B   BB    B       B      B BBB  B                B  B  B   B  B    B   BBB B     B   B    B
       BB    B   B     B  B        B B    B  B  B            B B   B B B  B         BB            BB 
           B          B  B    B           B        B B        B     B       B   B          BBB    B  
               B       BB    B  B     B   B B  B  B         B   B          B   B   B     B   B  BBB  
       B    BB BB        B B        B  B              B B B B       B              B            B    
    B         B        B       B     B      B    B  B  B    B          B BB             B B      BB  
B  BB   B B    B    B  B  B   B          B   B    B  B  B     BBB   B               B          BB    
  B  B B BB    B        B  B          B           B  BB   B         B   B B     B      B  B   B      
            B        B   B    B     BB    BB B BB   B   B B            B B             B     B  B  B 
 B  B    B    B B   B         B B    BB      B    B B B B B            B    B  B     BB B     B      
   BB     B       B        BB  BB     B       B          B BB    B  B              B B B       B     
B     B    B                        B  B                   B    BB    B BB                B     B  B 
B        BB  B          B   B  BB  B         B B        B      BB  B         BB B B    B    BB  B    
BB            B  B      B B B BB     B  B  B    B  B  B B         B B                BBBB  BB        
           B  BB               B      B    B     B B BB        B  B     BBBB  B               B      