B  B   B  B  B  B   BBB              B BB B     B         B B  B    B      B          BB    B   B  T 
      B       BB BB BB B     B                        B        B                     B        BBB  B 
     B      B      B  B      B          B   B  BB   B       B      B  B        B       B           B 
  B     BB    BB               B  BB  B   BB                    B      B B   BBB   B    B   BB B     
B BB          BB BB B   B         B        B               B    B  B           B  B  B       B  B  B 
  B B     B   B  B    B                BB B     BB  B    B     BB      B        B     B            BB
        B B   BBB  B     BB      B  B  B   BB    B     BBB   B  B  B   B                     B   B   
                   B         B B       BB      B  BB      B       BB     B         B B B   B B BB    
                     B    BB       B B BB  B  B        B  B       B      BB       B   BB B   BB  B  B
        B   B          B   B     B     B  BB BB       B B  B        B         B   B                  
  B B  B              B                B     BB   B     B B     B       B   B    B     B B BB  B  B  
  BB          B           BB   B B   BB                 B                      B    B       B       B
BB        B          B   B      B    B      BBB  B       B B       B B      B     B B  B  B B B  BB B
              BB    B                        BB     BB     B B  B       B     B B      BB  B  B      
BB     B   BB           B     B B     B B                  B B        B B     B   B       B B     B B
   B   B      B       B     BB  B B BB          B           B  B   B   B                            B
     B B          B     B             BB  B B B B    B  BBB  B   BB  B                    B          
       B B BB  B  BB          BBB   B BB      B B  B  BB       B       B   B              B  B  BB   
    B  B B B      B         B   BBBB   B  B     BBB  BB    BB     BB  B BB                 B  B     B
B      B  B   B B B     B    B   B              B                B             BB            B   BBB 
            B      B     B   B       BB      BBB              B            B        B     B B B      
 B  B    B            B   B        B    B   B   B B   B  B    B  B      B     B     B     B     B    
B           BB B                  B  B     B   B         BB    B  B BB         B     B        B    B 
B       B  B         B B    B   B B            B     B B B       B    B         B          B  B   B  
   B    B B B                B        B          B   BBB   B     B      B     B B  B BB    B       B 
    B B      BB         B        B         B B  B   B  BB  B BBB      B    B        BB   B  B      B 
   B B B B    B     B           B  B B  B                  BB      B  B B B B       B  B  B        B 
  BB BB B     B      BBB BB   B    B  B   B   BBB                    B   BB    B         B  BB  B  B 
   B   BBB    B      BB  B B  B    BB    B      B         B     B      B B  B       B        B    B B
   B     B B        B     B   B        B B                B B   B    B     BB B   B B B   B    B   B 
     B     B           B     B   B    B    B                 B  B B          BB     B B   B    BBB   
    B            B        B B   B B   B      B B         BB      B    B B    BB   B      BB      BB  
   B    B         B BBB   B      B    BB  B     B      B B        B B    B      B B   BB       B    B
  B     B       B   B    B            B     BB   B      B B     BB B          BB  B         B        
 B  B  B BB   B         B      B B   B    B  B       B       B    B     B     B       B    B    B    
        B   B        B  B B        B B                   B    B  B           B       B       BB BB   
 BB B B  B       BB      B  B B B  BB     B        BB  B   B         B    B       B          B  B B  
BB  BBBB   B               BB      BB    B  B B     B  B   B       B B       BB      B  B BB  BBB    
         B    BB   B   B              B          B          B     B  B   BB            B B  B   B B B
       B  BB   B  B   B   B     B   BB       B        B B B     BB         BB    B B   B      BB B  B
        B  B  B   B B  B B B                 B    B B      B   B  B B B    B         B  BB       B   
B B    B        B       B B   B B  B      B B               B  BB  BB   B   B        B  B B          
 B  BBBB         B   BB   B   B BB  BBB                     B        B           B       B B   B     
 BB         B       B B  B        BB     B   B       B         B B        BB    B       B     BB BB  
    B    B      BB                  B         B              BB                               B      
 B        BB  BB    B  B      BBB  B    B B B   B    BB     B          B B                  B  B    B
BB B           B     B B B BBB    BB  B    BB       B           B   B BB B    BB B B     B   BB B  B 
 B    B      B   B   B            B         BBBB      B B B                  BBB    B       B B    B 
    BB    B          BB                  B  B     BB               BB     B   B    B  B        B   B 
     B       B       BB  B  B        BB    BB B        B     B          BBB                B      B  
BB B B    B BBB  B B     B   B   B   BB  B            BB  B  BBB             BBB    B     B B B      
      B  B  B B         B B B         B   B B B    B  B      B   BB                     B            
  B BBB     B  B    B         B B         B BB   BB B  BBB     B B       B            BB BBB         
       BB  B B    B B  BB    BB      B   B         B                B         BB   B   B             
        B                   B      BBB B       B B      B BB BB B B        B  B BB BBBB  B           
    B        B                 B     B    BB    B          B            B   B  B  B         B B      
B      B B  BBB  BBBBB  B   B  B B   B      B      B  B     BBB       BB    B       BB  BBB      BB  
B           B  B   BB      BB  B      B  B            B BB      B  BB                          B B B 
   B BB               B   B              BB B  B BB      B   B      B   B                      B  B  
       BB  B       B B    B  B          B   BB        B  BB    B   B     B      B    B   B       B   
          B  B B     B   B           B          BB   B  B    B     BB   B     BB  BB       BBB B  B B
         BB B    BB   B  B   B  B   BB       B    BB  B    B  B  BB B   B BB    B     B           B  
BB   B      B  B            B   B     B    B B B    B    B    B       B    B        BB B      B B    
    BB     B B             B             B                     B   B   B        BB B  B    B  B BB   
         B       B  B                      B B  B  B      B B     BBB   B B      B     B    B  B  B B
 B          BB   BBB   BB        B  B   B B B   B   B   B B          B  B              BB     B   B  
          B         B B     B    B  BB BB   BB BB   B    B     BB  B    BB               B     B     
B    BBB  B     B     B  B           B    B    BB  B  B        B    BB   B       B   B  B   BBBB   BB
B  B                    B               B     B  B B BB B            B   B    BB        B  BB       B
B    B      B BB     BB B  B       B   B     B    B  B B             B              B        B       
  B     B   BB          B B   B             B B         B         B    B   BBB    B  B           BB  
 B  B    B         B   B         B     B B   B   B B       BB          B    BB  B    BB  BB     B  B 
     B   B  BB B           B  B          B  B       B        B      B      B B    B   B   B   B    B 
  A    B BB B      B       B     BB    B  B   B  B     BB  B       B  B  B  B                    BB  
       B            B B       B    B         BB      B  B B       B  B  B   B        B         B B  B
B    B            B    B     B   B        B  BB         B          B  B                 BB B   BBB   
   BB   B   B                 B B  B       B B B               BB      B B         B    B B  B  B  B 
   B  B        B  BB   B          B  B    B         B       B BB B         B            B    B  B  B 
 B            B B     B       BB   B                       B  B   B        B  B    B  B  B  B   B B B
BB        B   BBB                 B BB B B   B   B B          BB    B B B  B BB B   BB      B  B    B
  B      BB        B  B      B     BB    B      B         B  B    B B      B               B        B
  B  B           B      B  B     B B  BB      B  B           BB B B  B B B                BBB  B   BB
    B           B    BB        B B              BB    B BB           B         BB           B BB     
            B                     B  B BB         B        B       B  BB B B       B    B   B     B B
             B             B  BB       B      BB  BB    B   BB B    B BB         B B            B    
     BB         B BB    B         B  B   B     B   B B            B   B  BB B B    BB  B  B      B   
  B     B   B BBB     B                   BBBBB  BB  B BBBB  B        B      B    BB B       B       
 B  BB B   B   BB B    B    BB       B B   BBB  B B   B  B     B             B    BB      BBB  B     
   B           B                 B   BB    B   B                 B    B       B    B     B   B  B B  
            B         BB   B             B    B     B B  B     B  B B   B    B   B         BBB  B    
      BBB       B     B     B  B  B      BB   BBB   B    B B               B B  B      B  B      BB B
B        B   B             B     B                B           BB            B     B         B     BBB
B   B      BB             B  B   B  B       B             BB   B B    B  BBBB          BB            
  BB B        B  BB     B    B B  BB   B           B        B    B B B   B   BB      B         B     
         B   B        B B    B  B B  BB B         B       B BB     B B B   B B B            BB  B  B 
B B   B BB                 BB    BB  B    B    B         B B      BBB B B                         BB 
 B        B       B      BB         BB      B  B  B  B  B  B           B  B   B          B    B      
               B            B B     BB     B B B   B   B          B  B     B  B    B            B B  
                     B           B            B BB     B   B             B B  B  B   B       BB   B  
BB  B           B        B B B   BB          BB       B BB  B B  B B    B   B B B       B            
 B B      B BB  B       B            B B           B     B      BB      B  B    B   B B  B    BBB   B