B      B    B              BBB   B B         B                  B       B     B  B     B     B      B
     B       B           B    B       B   B BBB B  B                  B           B   B  B       BB  
BBBB   B             B      B    B B      B BB      BBB  B     BBB     B  B            B   B  B B    
          BB     B  B    B     B BB  B  BB      B           B      B               B            B B  
    BB      B        B B  B BBB B        B      B          B   B B B    B        BBBB     B          
  B       B   B  B      B B  B   B  BB      B    B                 BB      B       B B   B          B
 B        BB    B  B                B BBBB    BB  B      B B          B B         B   B B BB    BB   
 B B    B BB B  B  B    B         B  BB   B       B     B     BBB  B        B               B  B     
                 B  B B                BB  B             B             B  B         B  B       T     
       B               B    B      B       BB   B       BB       B B                        BB BB B  
     B             B    B B            B    B        B  BB B BBB   B             B    B           B  
       B     B           BB   B  B    B         B     BB           B BB  B  B  B              BBB  B 
   B  B  B  B  BB          B  B       B       B          B    B   B   B   B B  B   B        B  B B   
B  B B  B           B   B       B B               B   BBB B B       BB    B  B      B B   B B    BB  
       B    B   B              B     B      B   B   B   BB   B      B         B      B     BBBB  BB  
     BB             BB  B  B B          B  B       B     B B    B    B BB   B    B BBBBB   B         
    B   B   B B B     B   B    B  B   B B  B             B      B                     B B      B B  B
B               B     B  B B  B      B    BB B    B      BB      BB B   B B         BB    B          
             B        B        B      B       B        B      B   BB  B   BB B  BBB       B       B  
     BBB B     B         B BB     B    B   B         B     B B    BB B  B               B B B  B  B B
  B B B  B          B         B  B B     BB    BB           B   BBB   BB B     B         B BB     BB 
   B       B B BBB   B B     B      B B B B B        B        B  BB              BB B      B   B     
B  B B  B B   B  B   B B     B B    B            B   B   B                     B   B B BB     B      
  BB B   B  B    B                BB    B           B B          B     B   B    B B         B  B     
B          B BB       B   B B     B     B  B  B B    B   B           B  B BB       B       B        B
B B B B   B  B         B      B   B BB       BB BBB        B  B  B B      B      B  B  B       B    B
  BB BB       B    B  B   B                 BB        B     BBB B B   BBBB    B  B B B B             
      B    B     B  B                   BB         B B     BB     B  BBBB B B   B        B B     B B 
  B    B   B   BB   B           BB       B    B             BB B      B  BB BB       BB B B       BB 
         B  B B          B           B               B      B  B    B     B                 BB   B   
 B    B        B                      BB         B          B BBBBB   B  B B    B               B    
 BB   B    B     B           BB    BB        B           B B   BB B              BB        B         
         B       B B    B B  B B     B BB            B   B        B        BB   B B           B   B  
B               B     B          B     B          B    B     BB    B     B  B     B            B  BBB
    B     B B       BB        B    B       B          B          B          B   B  B B    B  BB    BB
       B  B   B      B B                 B     B       B     B     BB   B           B B          B   
 B  B      B BB           B     BBB             B       BBBB   B B         B B      B        B       
     B         B    B      B      BB B B B              B B  BB    BB   B               B      BB    
B B    B  B B B   B        B      B        BBB  B       B     BB BB  B       B B B   BB    BB   B   B
    BBB B   BBB    B   B   B   B       B B   BB B             BB    BB        BB BB                B 
            B B      BBB B    BB B             BBB         B  BBB   B  B    B     BB       B    B    
  B            BB         B     B           B   B B         B B                   B  B    B    B  B  
  B B     B         B       B    B        B  B             B     B  B B     BBB     BB B             
         B    B       B  B          BB     BB    BB B  B            B    B     BB       BBB     B  B 
     B    B    BBB    BB B              B BBB           B   B  B     B    B B   B B                  
       B BB            B         B   B      B    BB B          B              B   B B     B    B B BB
B B           B B            B B       B         B  B B           B BB     B     B B  B     BB      B
B         BB      BBB  B     B       B  B    B  B             B   B      B          BB     B         
B     B B B               B B           B   B     B              B      B  B           B BB         B
  B BB B B   B   B  B               B BB      B   BB  BBB   B     B        B    B B     B            
   B B   B  B                    B            B      BB BB   B  BB  BB        B          B BBB  BB   
 B  BB       B B BB  B  B  B             B  B B          B           B   B  BB        B     BB       
 B      B    BB  B B        B      BB      B     B         B      B     BB     B  B    B    B  BB B  
    BB          B B BB BB     BB         BB      B B             BB B      BB      B       B   B     
  B                             B      BB B        B  B    B       BB   B     BB B      BB B    B B B
   BB  B        BB       B            B  B        B B B          B  B        B            BB B       
B  B BB    B B        B           B                    B B         B   BB                B           
    BB         B   BB B   B  B       B      B      B B       B           B B       B   B    B        
          B  B    B        B B  BB        B   B   BBB                BB      BB     B                
 B           B          BB  B         B          B B  B      B B           B  B BB     B   B     B   
        BB              B BB  B     BB     B        B         B  BB  B   B     B                 B   
   B   B B      B          B         B          B    B      B   B  BB  B        B   B   BB      BB B 
 BA      BB B     B    BB      B      B           B  B     B       B     B   B  B                  B 
    B  BB B B    B BB B         B  BBBB B                            B       BB             B     BBB
    B    B B   BB      B      B    B     BB     BB   B B        BBB  B      BBB  B  B B B          B 
      B B   BB      B    B B   B    B       B        B B         B B   B  B      B     B    B    B   
   BB     BBB   B                    B    B              B   B   B   B  B      B      B B   B   B B  
BBB               B       B                      B B BB       B         B  B   B          B   B B B  
BB  B B   B  B     B     B B        B     B   B     B    B   B  BB     B   B    BB         B  B  BB B
        B     BB        B   B B      BB   B   B      B        B             B    B B              B B
BB   B  B B B  BB   B B        B    B          B      B BB         B    B        BB       BBB   B    
       B         B       B        B           B         B               B   BB         B B  B  B     
  B        BB   B BB     B             B       B        B   B   BB  BBB  B   B B      B              
B               B BB    B B  BBB    B    B B     B B      B    B     B  B B       B      B B      B B
     BB      B      BB BB      B          B B B B   BB       B   B  B       B   B   B   BBB  BB B    
BB     B     B    B     B                BBBB     B   B             B    BB B     B             B    
            B      B  B  BB      B        B     B    B  B         B  B   B         B      B     B B  
 BB   B        B     B        B B  BB B   B  B     B      B B    BB  BB    B B            B          
   B    B             B  B   B        B  B      B               B  B     B           BB        B   B 
  B  B   B   B B B B  B    B  B B  BB        BB   B        B B      B   B      BBB B       BB        
                   B           B   B    B  BB  B    B BB        BB   B  BB      BB    B   B  BB      
   B B         B              B               B  B   B  B                  B   B          B  B B     
 B             B         B    B     B  B          B  B   BB B                    B     B     B BB    
  B             B   B  B   BB  B        B   B          B  B  B                  B   BBBB        B    
B   BB B     B  B B         B        BB     B      B   B BBB B   B B  B      BBB              B  B   
                 B        B       BB    BB    B      B        B             B           B B     B    
 BB        B    B    B B   B  B    BB BB   B    B  B  BB    BB   B B    B                       B B B
B               B       B B  BBB  B      B          B       B    B            B           BB       B 
    B   BB   BB       BB        B   B    B BB    B       B      B     B   B   B      B      B   B    
   B    BBB B      B  B  B B  BB          B     B            B      BB  BB                         B 
  B    B        B                  B      B   B     B        BB     B       B B    B     B  B  B     
            B           BB  B B B   B   B   B B              B   B     BBB  B     B       B     BBB  
          B     B            B        B        B   BBBB    B          B     BB                  B    
 B  B  B       B   B B     B  B       B BB      B       B        B       B     B   B  B  BBB    B  B 
 B  B   B       B  B       B B  B B   B    BBB               BB B B       B  B B B      B B      B   
   B         B B        B  B   B    B     B BBB         B B   B      B               B   B  B     BB 
   B      B B                         B   BBB      B  B             BBBB  B        B B BBB B         
   B     B  BB    B        B    B B    B B B                            B    B      B   B   B  B B   
       B BBB       B         B   B        B           B B   B     B   B   B       BB       B    BB   
B  B       B     B                  B B             B B B           B     B  B  B          B         
 B        B                   B   BB  B             B   B           B   BB    B  B B    B  B  BB     