    B    B  B                   B  B  B B    B  B  B B          B     BBB          B   B     B   B   
  B  B  BB B  B B     B B         B   B      B      B            B    B BB        B  B   BB          
        B B    B                             B  B  B      B  B    BB   B B BB        B               
      B  B      B    B       B        B    B BB   BB      B    B    B            B     B             
 B      B     B BB         B B B      B        B  B      B B B         B    BB B  B           B     B
B  B   B     B B     B BB   B         BBBB     BB   B  BB     B  BB BB BB           B     B  B BB    
 B         B      B B        B        B B          B B      B  B     B  B   BB     B        B B     B
 B B B  B      BBB      B    B   B   B   B     B   BBB   B B  BBB  B B               B         BBBB  
 BB   B  B                   B BBB      B    BBB   B B B BB     BB       BB BBB        B           BB
       B             B       B           B   B     B         B                    B B B  BB       BBB
   B BB      B  BB     BB B         BBB  B   B    B    BB  B   B B   BBB BB   BB    B     B     BB  B
         B     B            B     B        BB       B   B    B B  BBB   B BB         B  B   B        
   B    B        B   B       B   B     B            B B                BB           BB       B       
B   B   B   B       B           B     B          BBB B  B    B  B BB        B B B     B B    B     B 
 BB     B BB  B  BB   B                  B  B B B       B BB                         BB     B B  B B 
BB B    B B  B B  B B B  B   B   B       B    B B                      B B B B     B      B     B B B
      B          B            BBB    B   B   BBB         B     B B    B B      BB     B B    BBB  B  
 B B    B    BBB  B  B B    B BB B    BB          B     B     B B    B    B     B     B     B  B B   
      B     BB BB  B  B      B            BB   BB  BB BB BB    BB     B   B  B              B       B
    B         B B       BBB B  BB  B            BB         B  B     B   B   B   B BB    B B   B      
    B       BBBB BBB  B B            B      B        B    B         B  B BB      B  B B   B          
     B         BB   B         B               BB     B                     BB        B        B     B
      B         BB   B        B                      B       B BBBB  B  B             B        B   T 
   B                 B B  B  B     B B     B   B   B    B                B       BB B                
   BB  BBBBB       B  B B BB   B   B B  B  BB BB  B       BB  B  BBB   BBB         BBB       BB B B  
    B  B             B   B BB         B  B BB B   B             BB B          B B   B  B     B       
  B             B              B   B    B BB      BBB        B B     B B    B  B B B B  B            
 B    B     BBBB            BBBB          B  B     B B  BB    B B          B B B BB             B   B
 B  B  BB            B   B      B BB   BBB     B  B      BB                   B   B B B BB   B       
              B   B B    BBBBBB        B B     B         BB BB  B BB B          B    BB   B B        
             BB  B   BB B           B     BB   B   B  B   B BB         B         BB BB B     B       
     B       BBB           B   B   B        B            B B  BB             B    B   B B B   BBB    
   B     BB        B      B     B      B  B           B    B          B    B         B  B B B B B    
 B            BB    B       B B   B      BB   B          BBB B       B B        B     B  B    B      
  B B     B  B   BBBB B  B    B  B B B     BB     B   B   B   B B B  B             B   B B B   B     
BB        BB B  B          BB  B      B     B   B   B BBB        B B B      BB B BB    B B B B  B B  
  B   B  B  B  B  BB         B B         B    B    BB BB      B  B  B    B    B      B BB  B     B   
B    B  B         B  B   B   B            B      B  B  BB      BB                B         B  B      
   BB     BB B    B B    B                  B  B         B             B   B       BB                
 BB      B     B        BB B     B   BB    B          B     B     B         B            B   B B    B
B    B B B  B BBB                     B  B  B    BB    B  BBB         B B     B     B       B      B 
  BBB             B   B BB B   B       B      B        B BBB  B  B B    B    B     B  B      B  B B  
   B       BBBB B       BB   BB  B         B      B                    B   B  B       B BBB    B  B  
BB  B BB      BBB B      B  B   B    B  B       BB       BBB    B    BB          B   B         BBB  B
 B            B   B  B B B B   B     B   B  BBBB  B  B  B      BB  B  B     B     B    B            B
B   B      BB           B        B             B  B  B       B    B         B  B   BBB    B  B  B   B
B       B      B         B  BB B    BBB B   B                     B B               B      B B       
B     BB          B    B        B B       B     BB         B        B BB                B      B     
   B    B   BB    B        B    B        B  B     BB                B   B            B BBB   B       
   B              B                 B       B        BB   B  B  B   B  B    B      B             B B 
       B    B   B         B                      B          B   B       B B          B   B   BB B    
    B      B  BB  B        B   B        B B   B    B   B B          B   B          B   B   BB       B
      B    B      B B               BB           B      B B B  BB  B                        B B   B  
B  B            B     B    B            B B       B            B  BB B   BB                BB   B    
B   B     BB  B     B    B       BB B  BB     B               B   B         B   BB B B          B  B 
                  B                     B      B            B   BB      BB     BB B     B   B        
     B  B    B         BB   B      B  B  B B BBB    B    B B    B             BBB      B B  B        
 B       B  B  BB B B B     B   B B    B  B  B       B  B    B BB BB BB   B     B       B      B    B
     B   B B  BB   B B BB B    B B  B      B        BB          B B   B B BB      B BB          B   B
   BB   B B    B      B     BB B    B B   B  B        B      B     B          B       B  B           
AB            BBB           B           B B B       B       BB B       B     B B  B       B   B  B B 
  BB   BB   B      BBBBB              B  B B  B     B         B   BBB    B      B     B  B  B  B     
B       B        B      B  B  B B    BB B       B BBB      BBBBBB B          B      B       B        
 BBB B BBB                      BB B B B B                 B  BB              B    B  B  B   B B     
B B  B  B                 B  B BB       B    B    B   B B  B  B    B   B      BBB   B   B BBBB   B  B
                        B  B   BB       B         B         B      B         BB  B      B       BB   
       B  BBB                   BB  B     BB B B       BBB       B B BBBBB   B B  B B              B 
             B B B             B         B            B   BB        B   B   BBB     BB      B B      
 BB     BB   B B   B         BB  B   BBB     B          B    BBB BB      B         BBB  B     BB     
B   B              B   B    BB           BB  B B     B   B  B               B B   B     B  B  B   B B
         BB     B   B  BBB    BBB                  B           B B      B      BBBBB    B       B    
     B           BB    B     B B B  B  B   B  B   BB     B    BB      B B  B  B B  B    B B  BB      
B      BB  B     BB    B     BB        B       B      B B   B  BB     B  B   B        B   B B  BB    
    B       B B             B   BB BB           B      B B B         BBB   B    B    B BBB   B       
B  B    BB     B    B B    BB          B   B  B        B  B   B  B   B         BB  B  B      BBB     
    B     B  BB     B          B        B        BB  B   B   BBB   B B           B  B   BB    B B    
BB              B      BBB      B   B B B    B               BB B      B        B    B B  B B        
   B      B     B     B       B      B B    BB    B BB   BB           B BB   B  B   B B BB          B
     B    B     B     B  BB BBB B          B B         B        B    B             BB  B          B  
      BB B               B            B         B   B B B                  B B   BB           BB  B  
             B      B   B B     B   BB    B B        B      B       B          B  B                  
    B        B       B        B    B  B B      B      B BB   B B                     BBB      B  B   
 B  B B    B    B B B  B  B   B  B B    B    B B     B      B  B B                 B    B B  BBB    B
    B       B     BB B   B                B    B B      B   B  B        B      B B    B B            
      B               B    BBBB          B        B         B      B B              B     B B      B 
 B     B     B B       B     B    B    B            B B  B    B BBB  B   B    B      B      B BB B   
                  B B       B    B B    B   BBB            B      B    B   B   B B B   B         BB  
 B    B    B   B       B    B        B B  B     B  B  B    B    B    B  B    B   BB  B  B           B
 BB      BB        B   B     B  B    B   B    BB B B  B  B     B       BB  B    B     B   B B   BB  B
         B    B     B      B  B   B         B   B B     B            B    B   B BB  B B BB           
    BB            B          B    B                   B    B          B    B       B  B            B 
   B    BB   B     B  B       B           BB     B     B   BBB   B  B      B B B     B B  B          
BB B   B      BBBB        B          B           B                   B B        B      B      B B   B
  B    BB                B B           B   B   B B    B BB       B     B          BB   BB      B    B
     BB  B    BB  B          B     B  B    B B     B       B    BB      BB          B       BB   B   
        B    B   B     B  B   B B B      BB          B  B B  BB B        BB     B       B B BB     B 
                 B       B     B   B        B B  B  B       BB B    B       B            B    B B BB 
  B       BB B  B  BBB     B               B     B        B      B   B  BB    B    B    B B         B
      B   B       B         B   BB    BB  B B  B  BB                   B B   B           BB   B      
 B   B    B       B      B   BB                   B      B B  B  B       B     B      BB          B  
      BB B              BBBB    B    B  B   B   B B   B  B     B  BB B     B              BB         