     B                      B B    B B   BB               B    B  BB         B                    B  
 B     BB    BB       B  B   B  B BB    BB   BB   B   B     B  B  B   BB           B   B   B    B  B 
 B B   B         B    B B    B B        B  BB B     B        BBB     BB BB         B   B   B   B     
       B              B  B         B     B       B    B B     B    B    BB  BB  B    B B  B B      BB
BB   B     B   B     BBB     B BB       B   B      B  BB    BBB   B  BBBB     B      B      B BB     
 B      B       BB  B               BB B   B   B    B      B        B   B   B                  B    B
B        B                       B                              BB  B     B B                   BB B 
     BB    BB             B      BB  B             B         B   B       B    B  B      B    B   BB  
                B    B  BB      B  B    B     BB B  B                          B      B     B        
   B B  BB   B  B    B  B       BB      B           BB    BB B     BB  B    BBB        B  B B B   BBT
  B B         BB B          B  B       B   B                   B  B           B     BB               
 B B B B B   B             B B     B    B BB  B B     B             B                     B      B   
                  BB BB B           B  B        B   B        B   B  BBB           B B    B   BB  B  B
          B B     B B BB B  B BB  BB             B       B        B      B           B   BB       B  
          B  B     B  B B           B   BB         B B  B     B  BB       BB      B   BB             
         BB  BB    B  B    B            B  B    B         BB    B B            B            B      B 
     B     B          B   BB  B    B B    BB  B     BB B          B         B      BB   B  BB B  BB B
 B  B     BB  B    B   B BB        B    B   B  B          B        B    B   BB            B          
         BBB   B      B      B  B               B          B          B  B  B   B      B         BBB 
         B  B           B B       B  B        B BB   B BBB     BBB   BB B         B B      B         
 BB           B        B     B  B     B       B                            B  B       B  B B      B  
               B    B BBB                     BB     BB               B  B B         B      B     B  
 B B   B B       B           B B B    B   B  B   B  B       B     B  B BB  BB  BB B       BB    B   B
B                   B   B B  BB        B    BB  B B BB      B      B   B BB B   BB B   B BB      B   
    B B   B   B  B                     B                 B    B  B  B  B B  B B          B  B BB     
   B      B     B B B   B         BB      BBB BB             B         BBB      B BB       B  B   B  
 B  B      B    BB     B   B        B BB          B  B   B  BB      B            B B     BB  B B B   
     B         BB B    B      B         BBB B            B    B B B       B      B B        BBB     B
 B          B  B  B   B BB B           B                     B                BB     B               
       B     B   B      B       B    BB      B     B B        BB B   B B   B   BB            BB BB   
    B  B   B     B   B BB             B B        BB      B    B B  B B   B B  BB B   B   B B   B    B
 B     B    B          B               BB  B BB         B      B BB          B  B   B B BB         B 
                 BB    B            B      B                 B   B    BB B     B B B         BB      
 BB      B    B   B         B   BB B B B         B B     BB    B B        B     BB  B BB  BB   B   B 
   B               B  B B    B  B  B            B                   B     BB  B   B  B         B    B
     BB      B                    B                 B    B  B BBBB B               B B            B B
   B      B  B       B  BB   B B B B B  B   B           B B  BB      BB              B             B 
BB B    B    BB B BBB       BB    B       B      B     BB BB            B      BB               B B B
BB     B                B        B      BB      B    B     B  BB        BB     B           BB B    B 
           B B              BB      B          B  B  B                         B     B  B     B    B 
   B  BB        B B  B BB  B   B   B       B   B   BB   BB  B BB  B  B B  B     B  BB  BB        B   
      B     B   BB       BB             B B  B         B  B  BBBB        B B B  B                    
    B     BB          B   B    B    B B BBB BB          B   B B B                  B B     B       B 
    B    B    BB                B              B      B       B       B      BB      B  B         B  
            BB  B     B B       B B      B            BB   B   B B  B    BBB  B   B  BB B B     BB BB
BB        B B    B     BB B B B      BB BBBBB              BB     BB      BBB B   B        BB      B 
            B B B   B       BB              B            B                 B   BB B    B  B   B BB   
BBBB BB    B        B  B                     BB     B            B   B  B      B         B B  B      
  BB    BB BB BB B  B B BB B BB  BB              B             B  BBB         B     B B              
   B     B    B          B                          B                 B        BB         B   B B B B
    B         B  B BB       B     B                      B      B B                        B B       
BB   B B        B B         B B B          BB   B     B   B     B   B       B   B          B  B      
     BB        BB    B         BBB          B  B             B   B     BBB        B         B    B   
  BB BBB       BB         B  B  B   B    B         BBB    B          B  B  B              B   B    BB
    B    B      BB B  BB    BB  B    B     B                 BB       B  B       B      B  B   B B B 
BB          B B   B                 B BB    B B         B B B       B     BB               B   BB B  
         B       B B                   B  B  BBB  B B B   B              B B B    B  BB   BB  BB     
               BB      B      BBB     B    B       BB  B      B   B    B              B          B  B
BBB       B     B                  B  B  BBB         BB   BB       BB      B         B      BB      B
    BBB     B   B B      B B   B B       B  B       BB BB    BB   B     B BB B B                 B  B
     B BBB  B                               B  B       BB   B   B      B   B  B      B             B 
 BB    B           B   B       B B   B BB     B         B   B      B         B           B           
         B     B   B  BB             BB    B  BBB B B                  B   B     B    B           B  
  BA  BB BBB B  B          B      B     BB   B  B        B                  B   B   B               B
  BB   B B            B               BB BB B  B B  B   B          B  B       BBB      B   B  B      
B BB       B     B     B                               B B        BBB        B      B                
 B B     B     B        B       B     B B   B      B       B  BBB  B        B   B  B  BB   B       B 
   B    B       B  B B     B     B         BB B             BB    B       B            B        B BBB
   B     B             B BB BB B  B B B   B   B    B  B       B       B      B B BB     B B  BBB B   
 B       BB            BBB                BB   B          B    B   B B         B   B   B   BB B B    
  B B             B    B  B             B        B           B          BB  B B       B              
B B BB     B    B     BB   B   B BB         B  B       BB           B    B    B   BB     BB B        
B           B  B    B   B           B B B  B      B B    B           B  BB   B    BBB   B            
    BB BB         B    B   B B            B      B          B    B      B   B B B    B      B   B B  
B   BB         B B   B   B  B              B   B B B             B  B    B     BB    B B           B 
 BB   B       BB                                B   B  B BB          B  B B   BB B      BB   B       
          B B     B  B  BB    B     B       B B         B B     BB  B  B B   B            B          
B              BB B              B B  B      B      BB   B  BB     B  B      B  B         B B  BB    
          BB     B       B       B B       B             BB B    B B B    B       B B  B  B     B BB 
 B     B     BB               B       B     B            B B               B BB   B   B   B  B     B 
B    BB       B B     B    B  B      BB  B  BB B  B  B   BB    B      BB        B                 BB 
B     BBB BB B               B         B          B   BB       B B B BB   B B          B        B    
    BB         B         BB        B    B  B   BB    B        B       B  B   B        B        B  B  
   B    B   B  B              B   B               B          B      BBB  BB       B B   B B    B     
B  B                B    B B B        BBB     B   B   B    B             B     B     B BB B BB   B   
 B BB    B   B B  BB      B  B       BB B    B B  B          B      B              B  B              
  B B B BB    B  B                           B      B B              BB B     B    B           BB B  
              B              BBBB          B  B     B   B        BB B     B B B        BB    B       
         B   BBB             B     B     B        B        B  B    B    B B  B        B      B     B 
  B        BBBB   BB   BB     B       B         BB   B    B     B   BB   B      B    B     B        B
 B     B   BBB  B    B     B B       B     B  B        B B              B B B                  B     
   B   BB B B B    B    B  B  B  B     B       BB B   B      B    B           B B B  B BB            
   B     B   B B   B  B   B           B      BB    B   B                       BBB     B   B   B    B
         B           B BB     BBB    B     B   B      B  BB        BBB                   B B     B   
  B      BB  B                                   B     B     B   BB  B              B             B  
           BB      B    B  BB   B B    B          B            BBB        B B  B   B B      B        
    B  B  B     B   B  BB        B B   B  B    B  BBBB            B            B   B      BB        B
 B B  B   B       B      B    BB B        B     BB  B B            BB        B            BB        B
      BB  B   B     B       B   B B       B    B         B     B BB           B           B        B 
   B  B  B     B       B   BB     BB   BB           B  B    BB  B    BB           B      BB  BB      
  B        B     B BB  B              B            B      B BB    BB       B    B  B B B B      B    