   B B  B  BB           B     B      B     BBB B   B     B         B      B BBB   B    B   B B       
B  B     B     B       B B     BB    B B  BB  BB B   B B     B     B   B  B        BB B BBB          
 B      B     BBB    B        B   BB     B      B   B      B B           BB        B               B 
 B B       BB BBB        B   BB   B  BB  B   B B   B     BB              B  B BB B           BB      
 B B   B    BB          B B        B                B B   B   B   B B B B                 BBBB       
 B        B   B    B B B    B      B       BB    B                  B B  B     B  B  B  B   B        
    B B                     B    B        BB  B             BB           B     B   B B B     BBB B B 
       BB     B       B B        B     BB         B     B     BB B       B     B            B  B B   
 B    B         B          B B       B B  BB    B         B B  B     BB   B B  B    BB       B    B  
BB B   BBB          BB B      B                      B   B          B      B    BB B    B         B  
      B  BBB B     BBB       B        B  B    B   BB    B B   BB B    B        B    B           B  B 
 B     B   B             BBB                 B B   B B       BB      BBB   B           B B    B      
BB    BBBB     B   B       B     B  B  B    B B B B   B  B   B   B             B   B   B    B   B    
 BB B                B   B B      B BB               B   BBB            B  B                 B B     
            BB           B         BB         BBB  B           B B BB B                   BB B     BB
   B B BB BB           BB    BB    B B              B    B   B B    BB  B    B  B      B   B  BBB    
     B     B  B  BB        B     B         B BBB       B  B      B    B B B B  BB   B   B    B  B TB 
   B   B                     B              B     B     BB B         BB     B B B   B    B  BB B   B 
        B  B B   B   B    B   B  B       B B   BBB B  B B      B  B B    B     B          B BB    B B
                    B  B B B               B B B B   B B  BB                   B   B  B      B  B B  
  BB    B BB    BB B     B B B    B BB      B          B B      B B                    B   B  BB     
      B       BB B  B    B                      B                 B       B B    B B B  B  B     BB  
 BB          B  BBBB    B    B     B   B   B B      B       B B  B  B          B              B      
    B   B      B       B BB  B B     B B      BB    B    B             B   B   B       B   BB    B   
     B               B  BB BB     B    B       B       BB    B   BBB  B                              
 B  B          B        B    B B B    BBB B  B      B  B             B     B B      B B  B  BB     B 
   B                B         BBB     BB    B     B     BB B  B      B             B                B
        B    B  BB         B    B B   B    B        BB       B  B   B    BB    B   B     B    B   B  
     B         BB        B   B    BB            B    B B        BB  B   BBB  B  B   B  BB B B    B B 
 B BBB     B  BBB   B B B    B    B     B  B          B                 B      B    B     B          
        B      B         B B   B   B   B B  BB              B B                  B  BB   B   B     B 
       BBB   B    BBB     BB    BB B    B        B B B       B     B            B      B B B   B B B 
  B  B   B    B   B              B B B  BBB BB     B    BB    B  B     B  B        B   B B B    B    
B    BB   B    B          B B  B B B           B               B       B   B  BB             B       
        B        BB       B     B   B         B   B                B        BB  B B   B            B 
          BBBB    B  B  B  B BB B B        BB B           B B  B   B      BB BB                 BB   
                   B B            B B B  B    B      BB   B    BB BB          B  B               BB  
 B  B  B        B   B      BB     BBBBBB       B   B   BBB  BB      B                       B  B     
       B  B             B  B  B       B B      B  B  B B               BB BB            B      BB  B 
        BBB BB B B         B             B                         B           B    BB B B     BB  B 
BB  B   B          B                BB B   BB   B       B  B B B  B     BB BB B B BB           BB    
               B      B        B     B    BB B B    B  B  B               B           B   BB B  B   B
 B        B   B         B B      B                BB   B   BB B     B          B BB  B B B    B     B
        B       B   BBB  B B   BB B B      B B     B     BBB             BB         B     B      B   
 BB BB B   B    BB B B  B   B  B         B B          BB  B  B        B     B B    B    B   B        
             B     B    BB BB   B              B             B    BB                 B B        B B  
 BBB   B   B B BB B  B B B B       B  B    B     BB        B   BB                B         B         
 BB            B    B  BB       BB          B         B     B     B BB B          B          B  B    
   B B B  B         B   B    B  B                          B        B        BBBBB      B    B    B  
    B    B      B   B        BB            B  B  B B BB B B    B   BB  B BBB       B   B  BB         
 B A    B    B    B       BB  B       B BBBBB  BB          B       B  B       BB  B BB  B        B  B
    B              B     B B     B        BB            B BB   BBB     B B B         B               
    B        B  B    B         BB   B   BB B         B      BB B  B           B       B  B B B BB B B
       B                 B   B  B     B     B          B        BB     B  B  B         B    B       B
  B        B                         B B  B   B      B B               B B   B     B        BB B     
        BB       BBB   BBB   B B     BB B B    B   B     B   B      BBB    B  B    B B    B BB     BB
   B   B   BBBB       B B B           B BB       B BB  B   B              BB         BB   B        B 
      B    B  B   B       B       B    BB        B  BBB B      B   B     B       B          B    B   
   B B       B BB  B  B  B                    B  B        B  B               B       B      B     B  
   B B    B   B         B          B  B             B       B    B           B   B    BB B   B       
         BBB B BB        B     B     B            B  B BB    BBB     B     B   B         B    B B  B 
      B            B   B             B B            B             B      B            B   BB         
B       B   BB         B B B   BB   BB   B  B      B B         B B  B   B B         B      B        B
B         BB  B   B       BB   B    B             B    BBB   B        BB  B BBB B           B   B BB 
   B     B        B  BB       B                 B   B         B      B    B   B    B B       B      B
        B  B   B  B     B   B  B   B          BB           B    B       B B                          
 B              B  B        B B           BB   B     B        B  B  B   B            B   B B  B   B  
       B  B   B      BBBB B B    B   BB       B                   B   B  B         B  B  B    BB     
  B   BB  B        B             BB       B  BB         B   BB BB              BB     B BB     B   BB
B   B  B B BB  B BB       BB  B    B    B  B B  BB           B B   BB      B          B    B   B  B  
   B      B  B                      BB   B             BB     B    BB B B B BB       B        B BBB  
    B    B      B                 B           B B B B          B        B              B   BBB   B   
B    B  BB     B   BB             B  B           B  B           B    B B       BB          B  B   B  
   BBB     B    B      B  BB             B  B     B B B    B B    B  B BB   B    BB BB  BBB B    B  B
      B       B  BB  B  B B   BBB  B    B B           B  B      B      B         BB  BB     B        
  B    B  BBB         B   B B             B   B   B      B  B B      BB             BB      B     B  
  B B          BBB B  B   B B                 B  BBB          B  B        B  B BBB BBBB  B    B   BB 
          BB    B  B       B  BBBBB       BBB        B  B   B B   B B   B        B  B    B          B
 B BBB         B     B B B            B B   B      B   BB      B B   B           B  B  B       B     
                 B      B B       B                  B B  BB B B   B  B  B B        BBB B BB        B
 B       B   B       B         B B  BB B      B                      B    B BB    B                  
B  B            B    BB   BB B B       B      BB B    BBB                   B  BB   BB      B        
     B        B                   B  BB   B   B   B B B   B     B BB        B    BB B  B           B 
  BBB B BB  B B       B  B   BB   B         B   BBB      B       B B  BB         B B                 
     B      B    BB   B          B         BBB                    B  BB     BB   BB  B    B B     B B
          B         B B B B       B   B     BBB     BB           B BB       B  BB    B BB            
   B           B   BB  B B     B     B        BB BB BB        B         BB                      B    
B B     BBB    B B B  BB             B         B       B          BB BB      B     BBB  B B B    B   
   B   B B         B          B B    B       B    B            B B    B    B          B B      B BB  
    B  B           BBB       B  B  B B     B  BBB  B  B       B   B   B  B        B                  
  BB   B                B       B     BB   B  B B                   BB   B             B  B       B  
    BB  B B     B  B      B               B    BB  B            B      B      B BB      B    B  BBB  
 BBBB    B  B   B   B B B   BB   B BBB B B B   B B     BB B     B         BB  B     B B  B        B  
        BB            BB    B B  BB      BB   B  B          B            B         B      B      B   
B  B      B                       B      B B   B  B B          B B          B      BB             BB 
B      B  B             BB  BB    BBB  B     B B          B     B B      B          B    B      BB B 
  B B  BB   B      B BB       B   B  B              B B       B     B B        B      BB B   B  BBB  
B B        B              BB        BB           B       B                B BB       B             B 
     B        BB     B  BB        B B   BB B B   B    B   B                B    B  BBB         BBB   
  B    BB      B    BBB          B            B      BB       B   B  B  B    B  B    B      B B B   B
     B B B                B            B                            BB   BB  B           BB     B B  