    B BB      B BBB     B BBB B  B    BBB  B       BB      B                     B       B         B 
 B   B            B B       BB B     BB                   B           BB       B B             B     
   BB   B  BB B    B B B B    B  BB   BB          BBB       BB  BB  BBBB     B             B  B  B  B
            B           BBBB       B BB  B        BBB                   BB     B           B         
  B   B                B B     B          B        B   BB  B             B    B  B B        B   B B  
BB      B    B B    B B     B         B  B           B       B   B B B         B       B B BB    B  B
 BB BB             B       B  B    B  B B  BB B   B  BB  B  BB     B     B    B B                B   
                         BB    B B  B            B B         B        B B         B   B       BB B B 
 B  B B         B            B       B B          B            B               B     B BB B      BB  
 B  B                              B   B  B             BB B B  B   B         B    B B               
B  B       B      B    B   B  B  B  BB              B        B      B  B         B      B      B     
        B       B B            B  B       B    BB   BBB      BB    B           B B   B   BB BB B  B  
      BB                   B      B  B          B  B B   BB      B    B B      B    B                
 B      B                  B             B  B   B B B BBB  B  B     B B   B      B     B BB         B
   B   B BBB            B          B                B B B           B BB     BBB B             B     
   B       BBB B  BB B  B B   B              B      B    B B   B BB         B             BBB       B
B B     B   B     B          B          B   BBB B    BB    B    BB B       B   BB     BBB  B   B     
B   B   BBB    B  B     B   B          B           B BB     B BB  BB      BBBB       BBB         B B 
            BBB       BB      B B          B B      B   B          B      B B   B  B                 
B B  B  BB BB   BB B    B              B       BBB BB B       BB  B B     B B BB  B                  
      B                   BB        B  B      B B B  B B          B   B     B    B        B      B B 
  BB B  B                  B     BB B B      BB   B    B   BB     B                  B            BB 
   B  B   BB        B     BBB B   B            B       B B               BBB  BB   B B          BB   
     B B B B                     B B       B      BB                  B   B B        B          BBB  
B B      B BB  B      B   B   B    B B        BBB    B  B       B   BBB          B  BB      B    B   
   BB  B   BB  B     B    B  B        BBB      B    B BB   B       BB    B               B           
B       B            B B B B   BB  B  BB           B               B B   B   B        B B B       B  
B BB  B    B   BB    BB     B  B  B     B    B  B  B     B B  B    BB     BB BB      B   B           
B          B   BB        BB   B B BB B      B     B BB  B   B     B   B    B  B B B BB     BB  B     
      BB  B   B    B   BB    B B      B           B      BB            B           B                 
B      B  BB B B  B   B          BB  BB B      BBB   B     BB BB    B   BBB BB   B   B               
   B     B     B         B      B  B         B     B  BBBB    B          B   B    BB      BB         
 B B   BBB     B          BB B    B  B    B           B       BBBB  B   B      B B        B    B BB  
               B    B    B      B  BBB                B    B          B                B    B B    B 
B      B  B BB    B    B B   B             B B       B      B    B     B   B     B B BB        B   B 
 B BB      B        B              B  BB     B       B B       BB               B B              B   
 BB       B   BB B                B   BB   B     B           BBB       B B        B   BBBB  BB       
     B     BB B    B     B       B          BBB  B             B BBB  B      B    B  B  B BB BB BBB B
  B   B   B            BB    B B           BB       B    BB  B  BB B B   B  B        B   B  B      B 
   B               B         B B    B B      B                 B      B  BBB     B B    B   BB  B  BB
             B  B          BBB       B     B     B   BB   B  B  B B  B    B  B  B  BB BBB  B         
        B    B BB  B B         B BB       B B B B      B       B  B  B     BB   BBB     B       BBB  
    B  BB BB  BB    B     B B     BB     BB B       B  B        B    B    B  B         BB B  B   B   
  B A     B  B        B       BB    B        B           B      B    BB     B B  B     BBB    BB  B  
  BB  BB  B  B B          B     BB B   B   B       B   B             B B  B  B B              B B  BB
B  B  B       B     BB           B     B             B  BB                  B              B  B B    
   BB         BB  BB   B         B  B  BB  B              B  B    BB           B BB         B   B    
B  BB   BB   B          BBB      BB             B     B   B      B         B   B       B   B BB      
B    B B B B    B     B         B B  BB  BB          B  B  B       BB  B    BB     B       B         
 B  BB B  B BBB    B   B    B  BB    B  B      BB              B     B B  B B B             B B      
   BB  B            B       B     B     B       BB   B BB B                      B        B B B   B B
     B         BB BB   B     B  B B      B B  B B                 BB     B B        B    B B B BB B  
   B  B  B          B  B  BB    B  B                     BB   B  B       BB B    BBBB        B       
   B    BB    B      B                 B      B       BB                   B     B B B   BB         B
  B           B           B      B          BB     B           B     B       B          B      BB    
   B B          B       B   B B     BB BB            B     B BB    B    B     B          B  B    B B 
  BB B     B      BB  BB  B               B       B    B B       B B          B  B  BB B        B  B 
B  B B   B      B     B    B BB BB       B BB         B   B    B   BB      B           B    B        
BB   B   B    B                 B     B              B        B               B   B B       BB   B   
BBB        B   B   B   BBB   B  BB      B     B BB       BB BB                     B  B              
                   B   B       B      B   B BB           B       B       B B  B   B  B  BB       BB  
   B  B     BBB     BBB   B  B B      B B       B  B     BBBB         B  B      B BB   B     BBB    B
              B  B               B          B B        B        B    B             B    B           B
       B          B         B   B  B   BB        B  B        B BB B     B  B    B  B BB    BB       B
  B  B B                         B  B           B B      B    B            B BBB  BB   B B           
  B      B        BB  B     B              B      B        B B           BBB        B        B B   B 
B     B B                 B  B          B B        B   BBB           B  B            B   B BB   B    
          BB B         B               B  B  BB BB         B      BB     B  B   B     B   B B        
 BB BB  B B    B      B B      BB         BB    B    B BBB B BB   B  B  B   B      B  B B  B    B B  
       BB     BBB B          B              B       B          B               B   BB      BB    BB  
  B   B B     B    B  B B      B                     B      B     BB    B       B       B      BB  BB
  B                  B   B  B             B   B       B    B B  B      B  B     B        B        B  
         B                         B     BB B BB    B    B                     BB         B          
B   B    B  B        B         B  B  B       B        BBB  BBB     B B B       B B    B  B        BB 
 B   B          BB  B B   B    B  B  B                      BBB B             B  BB  B     B  B BB   
 B               B       BB  B      B  B B  B     B       B  B    B         B    B       B B         
                   BB     BB       B   B    BB       B    BBB       BB   B B             B   B   TB  
B  B      B B  BB         B BB            B  B B    B   B    B            B         B           B   B
        B    B B BB B    B                                                 B         B   BB       B  
 B     BB   B         B    B   B     B  B   B BBB BB    B       B B  B B      B B    BB              
    B                 B  B      B BB   B B           B  B             B B    B B    B B        B  B B
         BB  B  B B      B B                  B  B    B            B         BB B       B B  B    B B
 B      B       BBB      BB  B  B  B       B      B BB B          B      B   BB B B   B    BB       B
      B     B    B B  B     BB BB     BB     B  B          B  B      B B            B        B       
   BB             BB    B  BBB          B      B       B             B                    B  B  BB   
  B      B   B B BB  B         B    B  B     B B B        B        B B  B  BB   B   B       B    B  B
  B     B            B   BB B    B     B    B     B       B            B  B      B   BB    B       B 
  B BB    B   B B    B B    B BB B B    B  B       B         B           B     BBB                   
BBB    BB    B   BB           B BB  B B      B    B           B    BB B      B      B            B  B
B B B B B    B        B BB    B    B  B   B      BB B        B B BB      B        B   B    B BB      
  B BB B            B    B  B   B BB     B      B B  BBB   BBB    B    B BB   BB     B     B   B  BB 
    B              B            B    B   BB     BB         BB   B    B         B BB  B B    BB    B  
  B B   B B         B BB    B    B        B    BB     B   B      BB                   B  B       B  B
   BBBB B       BBB    B  B       B B             BBB       B   BB     B   B    BB              B    
            B         B B      BB                B    B B           B    B  B    B        B B     B  
 B          B  B      B  B      B                  B B B     B    B        B  B    B                 
      B  B    BB       B B       B BB  B BBB         B          B         B           B  BB B   B    
B  B       B        BB B   B        BBBBBB     B  B         B B         BB     B        B B         B
          B B B       B          B B   B          B     B    B       B    B        B    B      B  B  
   BB B        B   B   B  B  BB          B   B BBBB  B          B B                  B       B B     
BB  B        B              B  B  B       B            B      B            B   B             B       