B  B   BB     B     B B      B   B  BBB    B             B   B  B                     B BB   B   B  B
B B       B        B      B     B    B      B  B B      B B                BB      B                 
 B                 BB  B  B            B    B     B B    B BB B       B B  B BB  BBB          BB     
 B       B   B B B B     B      B B          BB       B BB     BB B  B BB    B BB        B   B       
             B  B  B        B    B   B   B    B   B  BBB B B          BB   B           B            B
     B     B   B B                B BB    B   B  BB            B  B    B   B B        B         B    
 B     B  BB    B       B    B     B  B     B   BB  BB      B B                B     BB    B B    BB 
 B         B   B     B         B                        B      BB BB         B B B  B  B  BB     B   
       B   BB     BB BB   B         B      BB      B  B B   BB      B B       BB       B  B BB       
B B B        B   B   B       B  B    B               B      B         B  BBB   B        B     B      
   BB    B     BBB  B BB     B        B B       B   B   B   B   B         B   B B  B B       B       
  B B    B   B  B B     B            BB   B    B   B B BB   B          B                     B   BBB 
     B       BB B B       B  BB  B                     BB      B             B B B       B      B B  
    B  BBB B      B B BB B  B BB        B                          B   B  B          B B  B   B  B   
    B    B  B    B         B     BB   B  B         BB    B       B       B BB    BB BB     B      B B
  B           B B  B      B B B       B      B          B B   B       B   B   BB      B B  B      B B
 B B          B      B     B  B B            B  B     BB                    B B  B  B      B   B     
      BB        B   B     B BB  BBB      B  B          B  B  BB    B        BBB BB       B  B   BB BB
   B B   BB  B B B         BB B B         B      B         B     B B      B             B    B       
          B BB    B      B   BB  B        B       BBB       B        B  B      B BB           B      
               B          BB  B  B     B       BB BB            B  B    B       B   B    B B     B   
          B B B B            B    B   B             B   B    BBB  B         B               B B     B
      B  BB  BBB        B  B B          B B B  B      B   BB   B    B  BB   B        B    B     B    
 B   B      B   B   B     B      B    B     B         B  B   B     BB    B B       B B      B B  B   
BB  B   BB B    B    B    B    BB   B     B   B  B  BBBB           B   B    B    B   B     B B BB    
 B   B        BBB      B   B  BB   B     B B              B  B     B      B            B      B     B
 B        B    B          B   B   B    B                 B BB   B      B  BB     B B  B      B       
            B        B      B    BB  B B    BB  B                B      B      B     B B   B  B   B B
   B     B      B           B    B  BB   B   B    B        B      BB        B         BB     B       
B B B B       B     B                B    B     B B  B            BB    B   B  B B        B         B
               B   B   B         B BB       B  B     BB     B B   B      B  B       B       BB B B   
  B      BB      B  B                  B    B  B    B     B B  B      B  B      B    B  B  BB B      
            B      B        B     B  B           BB             B                      BB  B     B   
B                      B                                B   B       BB              BBB  B B   B  BB 
  B B     BB B       BB   B BB BB        B         B   BB  B            B   B B BB B          B      
  B            B B    B     BB       B BBB    B       BB      B B B        B           B  BB B       
  B B  BB    B   B   B     B  B   B      B   B BB  B    B   BB   B   B     B     B B      B    B B   
B  BB    B   B  B              B   BBB B          B     B B B                 B       B    B  B    B 
   B    B  B B B B       B    BB          B  B B     B      B  B        B   BB   B B          B      
   B BB           BB B               B   B    BBB                 B  BB B    BB B B      BB  B  B  B 
BB              B B  B        B          B BB     B     B     BBB         B   B            B    B BB 
    B BB B    B      B  B BB B        B  BB BB     B            B      B             B    B          
                   B       BB  B     B            B         B         B  B    B B      B  B     B   B
  B   B         B     BB B B           BB    B     B    BB     B       B     B       B         B B   
             B   B   B  B  B            B   B  B          BB                   B             B       
                           B          B   B         B        B  B                    B      B  B     
BB B     B  B       B   B             B  B  BB                         BB B     BB BB   B    B  B    
B     B      BB   B BB  B       BB          B  BBB   B                B B  B       BB      BB        
 B           B BB         B          BB        B   B      B     B             B                    B 
                  B     BB B    B                              B       B        B         BB B   B   
BB        BB          B     B B  BB         BBB            BB        B       B B    BB B  B       BB 
 B  B   B B   BB         B    B   BB  B B  BB      B     B B B B    B    BBBB B      B B  B  BB    B 
        B  B B     B                 B                 B           B B BB           B  B   BBB B B   
    B  B  B B  B B B B             B          BBB B     B B  B  B       B     B    BB     B   B     B
   B                      B  B   B      BB      B B B           B         B B  BB     BBB B  B    B  
   B     B    B             B        B           B   B              B    B B B B  B           B B    
    BB        B B      B                B      B  B    BB     B   B           B      BB   BB    BB   
B B      B     B B  BB  B    B             B  BB      B     B   BB     B BB B         B  B B     B   
  B        B B  B   B    B BBB     BB           B    BB          BBBB          BBB  BB B    B   B B B
       B B  BB B B   B        BBB       B    BBB          B       BB        B   B B           BB     
   B      B    B                    B   B        B    B   BB       B               BB     B  B B  B B
  B  B B B   BB     B   BBB   B   B   B B BB          B    B      B         BB     B       B   B  B  
                   B BBB               B  B B       B          BB B  B B    B  B           B B       
B    B   B B     B  B  B B     B              BB    B   B  B   B     B   BB        B    B        BB  
    B BB   BB  B          B    B   BB  B  B                  B     B  B       B  B BBB           B   
 B B          BB         B  B B  BB                    BBB              B  B                    B B  
 B                  B  B                 BB    BBB BB              B                             B   
    B       B B           B      B   B   B  B BB   BB B         B    B      B                        
         B B       B     BB B B   B B B  B B        B     B       B   B    BBB    B   B B   B        
 B              B  B B      B         B                 BB  B                  B    B                
      B   B        B B      B B         B B     B      B B    B        B    B BB   B      B B   B B  
       B   B   B B  B       B     B    B      B   B            BB  B          B   BB                 
                   B          B     B     BBB   B        B  BB           BB  BB             B B B    
  B  BB      B      B    B  B   BB B B B       B  B    BB   B     BB    B  B    B         B         B
  B      B        BBBB         B      BBB   B       B          B  B      B   B   B B           B B   
 B        B    B  B        B  B   B   B  B   BB    B  BB     B                          B     B B    
BB            B  B          B   B           B  B   B B   BBB  B    B    B  B  B    B B    B   B      
B     B         BBB      B BB            B   BB B                        B            B     B   B  B 
     B B     B  B B B  B B  B                         B    B B    B    BBB   B B            B B      
 B BB B    B B    B  BB B                B B B    B B       B B      BBB       B B  B    B B   B T   
              B   BB  B        B      BBB           B   B     B BB    B        B               BB    
      BB     B        B                        B  B  B  BB    B         B B      B B    B     B  B   
    B      B  B B  B    BB            B B   B    B      BB  BB  BB        B   BB  B     B  BB   B BB 
 B  B   B   BBBB BBBB     B  B   BB  B   B B      BB B        B         B B      B     B B BB   B  B 
 A  B B    B BB B   BB   B B  B                     B B    B  B  B B   B       B     BB         B BB 
       B B   B  B         B        B       B B     B    B      B  B  B           B             B     
                BB B    B B             B B      B   B  B   B B   B                     B   B        
BB  BB  B BBB              BB B   B  B    B          B   BB B     B       B     B   B   B    B B     
               B   BB B                            BBBB   B                   B     B             B  
BB      B          B BB B  B BB       B   B  B  BB   B   B  B   B  B         B   B    BB     B       
      B        B B  BB             BBB B                    B       BB  B   B        B B BB BB       
   B      B  B   B           BB   B    B B   B    B    B     B B     B    B      B   B     B B    B  
  BBB        BB B        B  B                  B    B       B           B B   B              B BB    
BBB    B  BB B       B    B     BB   BB B   BB        B  B   B      B   B   BB  BBB    B  B   B  B  B
 BB   B          B  B        B BBB        B    B    BB   B         B B B    B        BB  B    B  B B 
BB           B        B  B     B                       B   B B B      B     B            B     B  BB 
 B  BB                B                 BB BB     B    B            B       BB     B   B B B B  B    
   B                                 BB B            B B          B    B                      B      
   B      B B        BB         B B  B  B           BB   B       BB   B   B       B   B             B
 BBB B  B                   B       B          B       B  BB  B        BB                            
 B  B                BB       B B     B      B   B  B    B    B     B  B B BBB BB    B         B     