                    B B          B                    B     B     BB    B       B    B  B   B B    B 
B B     B B  B        BB   BB B     B      B  B B      B     B B B    B B                B     B     
 BB          B              B  B   BBB B  BB      B       B            B  BB  B   B             B  B 
B B        B   B         B  BB B       B        B        B    BB    B BBB     B       B BB     B  B B
          B      B   B                 BBB           B   B    B BB   BB                 B  B  B  B   
B B            B    BB  B    B B   B  B                  B  B  B    B    B  B      B B   B  B  B B   
B B    B        B       B          B         B  B    BBBBB   B    BB  B   B B  BBBB  BB              
    BB         B       B                        BB    B              B B   B       B BB BB      B    
B BB    B   B    B              B       BBB BB       B  B             BBB     B             B        
       BB           B B     B          B          B       B                     B BBBBB B     B   B  
       B      B           B      B BB      B   B   B   B            B B BB     B B     BB B B B      
 B  B           B      B     B       B          B     B                          B     B     B  B    
                   BBB   B  BB B B                      BB             B      B B   B B  B BBB   B   
        B             B                    BBB      B  B  BB   B          B  B        B       BB  BB 
                               B    BB              B          B    B  B          B     BBB  B    B  
         B B B         B  BB      BB          B    B    B  B     B    B BB   B   B                   
                         B  BBB B            B   B B         B  B   B B          BBB          B  BB  
           B B B                   BB        B                 BBB     B BB  B   B    B        B   B 
 B   B  B  B     B  B          B B B            B  B       B   B  B B         B BB     B    BBB BBB  
    B        B  B B       BB             B       BB B   B       BB BB   B B    B  BB            B    
      B B  B   B B   B                    B       BB     B   B  B  BBBBB  B B B    B      BB BB  B B 
    B    B  B     BB    B                  B B             B          B    BBBB  BBBB   BB BB B    B 
B  B  B       B B      B  B B    B  B    B     B                B      BB     BBBBB B B B B         B
        BB   B     B       BB    B    B           BB  BB       B         B BBB      BB  B BB BB      
  B     B               B  B   B   B     BB   B   BB B    B B             B    B    B   B      B B  B
            B BB         B       B  B      B  B                     B  BB    B B    B     B     T    
B       B  B  BB      B  BB  B  B B    B  B B        B     BB  B        B      B  B      B      B B  
   BBB    BB  B     B                 B   B            B  B      B   B      B   B B    B        B B  
   BBB    B             B  B        B B B       B BBB     B BB    BBB                       BB  B B  
 B BB    B  B       B   BB B       B     B    B    B    BB B    BB    B BB BBB    B B   B           B
                           B                       BB B    BB             BB   B  B      B B B     B 
  B   B         B B   BB  B      B   B   BB   B       B B         B BBB            B             BB B
      B    BB      BB B B   B B       B      B  B   B                                    B B   B B   
            B    BB     B    BB      BBB   B                 B  B B            B   BB  B B  BB  BB   
                  BB  B   B             B   B  B    BBB   B             B      BBB                   
            BB               BB       BBB   B   B        B  B       B B   B B   B  B  BBB       B   B
  B    BB         BB  BBB    B  BBB B    B     B  B    B      B      B            B  B B   B     B   
      B           B     B  BB         B  B    B      B                    B       B            B    B
B  B    B B  B   BBB B       B         B B     B B     BB   B     B  B        B                      
 BB  B   BB  B      B B        B BB    B                    BBB B  B      B    B  B      B  B  B     
B  B        B   B   B        B           B  B   BB    BB    B   B     BB     B  B B        B         
               BB    BB          BB             B    B     B   B  BB     B   BB B          B   BB   B
B   B        B      B           B   BB B B     B     B  B  B      BBB   B   BB   B    BB   B   B  B  
 BBBB    B        B  B  B  B  BB  B B          B   B      B   B      B                    BBBB       
        B                 B     B   B    BB  B    B  BB                       B     B B     B     BB 
     BB B      B         B     B  B B  B   B      B B B BBB       B   B      B B   BB   B          BB
  B BB  BBB BB   B B B  B   B     B            B     BB B   BBBB     B       B              B        
  B    B B  B  B     B B   BB  B     B    B                    B  B                BB       BB       
      B      B     B BB              BB         BB B B B   BBBB BB      B B  B       B    B  B    BB 
B  B               B          B   B B   BB   B           BB         B  B B  BB             B    BB   
                   BB    B         B        B      B     B     B         BB  B   B  B        B      B
B    A B  B        B  B B           B   B    B  BBB   B BB  B B            B             BB       B  
   B B          BBB B     BB   BB  BB  BB  BBB BB    B         B       B  B  B     BB BBBBB     B B  
  B          B     B      B     B      B BB    BBB       B    B  B     B    BB   B B         BB   B B
      B  B      B       B      B    B   BBB     B            B         B   B        B B      B  BB   
 B           B B B      B    BBB   BB     B  BB    B             BBB    BBB  BB     B       B B     B
  B     B B  B B B     B   B               B     B  B  B B     B    B    B B  B BB     B     BB      
      BB      B  B      B      BB   B          B         B BB   B  B  BB    B  B  B B        B       
B BB BB          B        B B    B   BB              B     B          B B            B      B B B    
              B    B   B B      B B      B  B     B            B     B B         B BB  B        B    
    B B      B   B   B B   BB    BB B  BB     BB BB    B B    B         B B  B    B  BB              
B     BB     B   B    B      B      B  BB   B B     BB          BBB BB     BB      B  B      B       
   B    B        B    B      B   B  B               B     B   B       B  B    B    B      B       BB 
B    BB      B   B  B  BB     BB   B   B  BB BB    B  B    BB       BBB                       B      
                  B   B       BB        BB           BB       BB B B       B         B    B          
   B           B        B  BB       B B B    B     B B      B  B      B    B    B       B            
 BB            B B      BBB        B B B      B  B       B   B      B    B B      BB  B         BB   
         B    B       B   B       B   B                       B           B         B                
     B  B               B    B        B BB        B    B      B     B  BB            B       B B BBB 
B B       B                 B   B     B  B           B   B    B      B   B         BB   B     B    BB
  B B  BB   B        B       B  B B B          B              B  B B    BB     B   B         B  B    
B      B         B     B   BBBB      BBB    BB       B     BB   B B  B  B    BBB      B B  B   B B   
       B B         B      B  B B      B        B             B  B  BB B  B   B   B     BB   BB       
             B         B        B     B B       B B B                   B      B B     B    B  B     
         B B    BB  B BB B B     BBB     B   B   B   BB      B B   B              B         B BB    B
    B     B  B              B    B    BB  B  B    BBB   B       B      B  B   B   B   B   B          
    BB   BB B B     BB      B B  B     B B         B BB     BB B            B   B  B    B   B  B     
  BB B B      B     B              B         B   B B  B           BBB  B             B  B     B      
     B    BB  B     B                 B   B            B B   BB   B B    BB     BB   B   B B   B  B  
      B B B     B   B     B B B  BB    B   B         B      BB               BBBBB    BB           BB
B  BB B   B   B B    B  B B     B       B     B   B BBB        B  B B  B B    B           BB B     B 
          B B       B    B      BB  B B  B   B  BB B           B                B  B            B  B 
 B  BB B  B   B      B      BB   B    B          B       B B  B     BB  BB  BB  BB B    B        B B 
         B B         BBB        B  B      B B B    BB         B     B      B      B     BB    B      
 BB   BBBB   B     B    B B      B  B   B             B   BB B B B B  B     B               BB  B    
   B  B B    B          BB           B  B B  B       B B  B    B B        B    BB B         B  B B   
          B      B   B      B      B B  B   B        B B        BB B BB            B    B     BB B B 
B    B          B   BB    BB        B       B   BBB B  B     B     B     B   B    B    B B           
     B           B B  BB  B B      B B      BB                B   B       B BB   B             B B B 
       B  B               B    BB B  BB  B   B           B            BB B                    BBB    
   B  B     B B        B  B    B B  BB  B    BB B       B      BB                  B B      B    B   
BB      B  B B                BB     B   B B   BBB    B      B     B   B  B        BB      B     BBB 
  B   B     B      B  B  BB B  B       BB B  B B B B B    B      B    BB BB B       B     B        BB
 BBBB  B                      B   B        B  B           B    B    BB   BBBB    BB        B   B     
   B B        B  B       B              BB   B  B B      B B B    B          BB B  BBB B       B B B 
   B      B    BB B  B        BB            B      B     B   B B B B B      B  BBB             B  B  
     B              B   B           B  B B B    BBB    BB   B    BB    B       B   BB  B      B      
   B B  B  B B  B       B   BB B  BB    B       BBB     B     BB B         B         B          B    
     B   BB         B  B                 B  B     BB        B     B  B   B  BB    B B          B     
                           B       BB    B   B       BB       B B  B   B          B         B   B    
      B   B          B           B               B   B B      B      B     BB B   B  B    B B      BB