      B     B    BBB         B              B    B    B B B B  B B          B B        B    B       B
       B B            B    BB             B      B        BBB   B B        B B B   B                 
         B   B          B        BBB              B B   B      B BB  B    B  B          B   B  BB   B
B B   BB      B BB            B  BB             B B     B BB      B      B B B          B   B     B  
B  B  B B     B    B          BB            BB                 B BB     BB     B        B B  B  B    
 B  B B         B   B BB    B  B        BB B               B     B          B    B     B             
         B B        B      BB B   B B              B     B          B  BBB    B B B          B B     
   B                B    BB    B   B  B     B B     B         BB   B  BB B     B  BB      B   B  B B 
B   B     B   B     B        B     B   B B  B    B       B  BBB        B  B B B       B         B  BB
       B  BB         BBB   B            B  B              B    B B  B B  B          BBBB B  B  B BB B
  B        B    BB    B   B     B   B        B B     B  B           B    B   B    B                  
  BB   B          B   BB      B B   B     B BBB    B    B B     B         B      B    BB  B     B B  
 B    B BB          B       B  BBB  B   B B B  B B   B    BB   B  B  B B B B B    B     BBB  B       
     B BBB  B     B  BB       B BB   B    B  B B   BBB      B B       B           B B      BBB       
 B B   B         B          BB    B B                B  B       BB           BB  BB B   B BBBBB      
    B   B    B  B B            B B  B    B BB B        B                       B BBBB B B          BB
   B B    B BB  BBBB   B     B       B       B     B           BB    B                B         B  B 
    B BBB B  B   B       BBB  B  B              B B  B     B   B  B    B            B  B  B  B     B 
B   B    B    BB    B B B   B                B    B       BB               B B  B B  B    B     B  BB
B B B   B       BB B  B   B         B     B  B  BB                        BB           B            B
    B    B                      B   BB     B  B      B B B      B  B     BB      BB   B B         BB 
   B  B  B  B    B       B     B  BB          B     B         B  BB B          BBB                   
        B   B  BBB     BB   B       B    B       B   BB  B      B    B     B   BB      BB  B    B    
B       B      B  B        B         BBB     B  B    B           B        B   B B B                  
B  B BB     B   B      B                BB      BB     B  B   B  B    B  B          B        B       
 BBB    B   B    B        BB B BBB  BB    B   B B B    B  B  B   BB B  BB B  B    B     B   B  B  B B
B      B   B  B B    B   B B  B B        BB   B        B       BBB     B  B                          
       B   BBB            B B        B B    B B B       B       B   B  BB  B    B                  B 
  B  B        B     B  BB  B  BB      B  B              B  BB          B            B   BB           
   B B                B BB BB    B   B   B  BB   BB   B   B    B  B      BBB      BB  B     B      B 
              B          B BB B      B       B            B        B     B   B  B  B  B    B         
      B       BB   B  B B B    B      B   B       B    B          B   B  BB        B B B  BB       B 
                  B    B  B    B         B  BB    B   BB    B     BB  B B    BB        B       B B  B
   B       B  B          BB  B  B           BB  B         B  B                 BBB              BB  B
 B    BB      BB    B     B     B      BB    B     B   BB B   B   B  B       B     BB    B  BB   B   
      B           B   BBBBB B B    BB BB BB   B       BBB         B          B      BBB   B          
  BB BB  BB   BB  B B  BB      B BB      B             B              B B       B       B            
    B     B    BBBBB  B      BB       BB B   B  B          B B   B     B    B  BB   B    B  B B  B BB
B      B   B   B B   B  B B    BBB    BB BB         B      B  B    B  B   B B   B      BB B B        
   B    B  BB        B   B  BB  BBB   B   B    B  B             B        B B   B              B      
B  B                    B  BB         BB    B        B   B    B  B B B B      B  BB          BB      
   B          B B    B B       B   B       B     B       B     B     B  B   B   B              B   T 
B   B     BB      B   B    B B         B   B B     B            BBB             B           BB   B   
   B     B   BBB B             B        B       B   B  B    B B      B B            B  B           BB
   B       B B    B   B B            B   B B BB B B       B B    B B        B              B         
 BB      B B BB    B BB  B       B   B  B   B B  B     BB      B      BB             B BB B   B   B  
       B   B     B B   B    BB B                    B   B B        B        B             B          
BB   A  BB     B    B     B BBB    B     B       B             B   B    B  B  B  B    B    B      B  
     B B          B B B B B     B    B   B     BB    B B                   BB B      BBB BB B        
  B    B                  B     BB       BB     B   B     B   B  B  B                          B     
B  B  B  B B         B                      B             B   BBB BB   B        B B         B B    BB
     BB  B       B     BB    B   B         BB          B B    BB          B     B  B     B  B  BBB   
  B       B    B         B          B   B B     B    BB     B              B B    B BB  B  B B B    B
    B    B    B   B   BB    BB      B          B B         B B   BB   BB  B      BB   B  B  B   B    
 BB B     B     BBB       BB B B    B B BB               B B        B         B       B     BB     BB
 B          B BB B  B             B    B    BB B B    B   B           B    B B   B B  B   B B  BB    
      B       B      B      B B  BB    B   B     B  B B   B   B   B     BB       B         B   B   BB
 B    B   B               B                       B         B   B         B B  B       B B           
         B   B      B    B B          B B         B       B   B BB  B B         B   B       B    BB B
  B B   B        B  B      B B  B    B  B        B   BB         B         B      B         B     BB  
              BB       B    B          B    B   B         B B    B     B      B  B   B   B           
 BB    B   BB       B            B B       BBB   BBB   B        B              BB                    
     B  BB    B B   B       B         B   B        B B     B            B              B   B BB  B   
 B B    BB    B     B B     BBB   B        B                  BBBBB         B    B     BB       BBB  
B          B B    BBBB     B    B        B BB        B               B   BB B B      B BB B          
  B   B         B  B  B      BB              BB  B     B B           B   B          B      B   B  B  
       B                  BB            B  BB    B  B    B       B    B         BB           B      B
       B      B  BB      B    B    B  B   B  B         B       B             BB      B           B   
       B B  B     BB     B      B    B          B   B             BBBB  B                B       B   
    B            B   BB        B     B    B B   B      B      B    BB           B   B    B BB   B BB 
      B  B  BB B     B  B B                 B  BB   B    B B   B    B B BB           B B     B B B   
   B  B        B   B  B            B     B         B   B               B  BB    BB        B   B   BBB
 B     BB  BB   BB      BB  B         BB        B      B BB    B  B    B B     B         BB    B     
BB B         B B   BB          B B B     B BB   B             B         BBBBB     B B        B B     
     BB         BB              BB B   B       BB         BB B       B       BB   B            B     
 BB            B  B         B    B           BB     B     B    B   B    BBBB    B   B  B         B  B
      BB  B         B    B       B   B  BBB   BB    B     B  B B B        B  B  BBBB  B   B       BB 
    B   B B  B  B     B     B  B            BB   B                    B B   B   B  B     B  B        
      B   BB          B              B B    BB  B B  B B          B        B    B B   B     B  B  BBB
                    B       B             B   B BB       B B     BB      B    B   B                  
B B  B BB    B   B B   B  B B     BB B          B    B    B              B B    B     B    B  BB     
B      B   B             B B  BBBB   B BB BB         B              BB          B B                  
B   B B   B B                 B    B        B               B B  B     B  B           B    B B    B  
BB                  B                    B          B        B  BB      B    B      B    B           
   B         B        BB   BB B        BBBBBB    B BBB  B    B   B       B   BB       B              
   B   B       BB              B      B   B     B        B  B B    B    B B B             B     BBBB 
      B      BB      BBBB B  BB   B    B     B      B            B B           B  B   B      BB    BB
B  B B        B  B         B             BBBB            B        B  B           B B           B     
        BB       B        BB        B    B   B B         B B   B   B                   B  B      B   
  B    B B    B           B   B            B  B   B   BB       B  B              B         B  B  B   
     B      BB  B    B  B     B       B  B    B   B BB  B                         B B B    B BB     B
   B    B  B  B B   BB  B       B     B   B         BBB     B B B     B    B B  B  B       BB  B     
B    BBBB      B      B B  B                 B     B      B         B           B          B B       
   BB B BB    B    B BB     BB   B        B  B               B  BB              B        B       BB B
         B  B  BB   B B    B BBBBB     B    B     B     B  B     B      B    B  B B B          B B   
 B         B   B BB    BB                 B   BB B B BB B     B   B  BB    B      B      BBB    B   B
    B     B       B      BB  BB B  B        B  B  B BB   B     B      B   B     B  B           B     
   B B    B        B     B B          B    B BBBBBBB  B  B  B           B    B    B     B  BBB    B B
 B      BB   B   B      BB  B            B B                 BB    BB  B   B  B       B        B  B  
    B  B              BB         B       B  B     B  BBB      BBB     B BBBB B      B  B  B B B    B 
 B        BB           BBB  B  BB      B  B          B B   B     B   B     BBB BB      BB    BB  B   