      B  B   B    BB   B  B         B     B B B     B      B       B                            T   B
  B B    B BB     BB B    B  B                  B B        B        B         BB           B         
   B   BB   B                  B  B              B   B                B B       B    B       B       
        B          B   B        B  B   B  B           BB        BB           B  B  B                 
 B         B B BB B  B B           BB       B  B  B            B   BBB       B       B B             
           B B  B  B            BB  BB   B    BB            B       B   BB B   B          B         B
     B       BB  B  BB            BBB B  B    B                               B B B        BBB B    B
     B           B   B             B B          B     B  B  B B  B  B    BB   B     B  B    B        
        B  B              B   BB  B  B B B      BBB   BB   B  B B B            B   B   BB  B  B      
   B       B BB  B             B     B      B           B    B           B   B   B BB  B      B      
        BB   B          B       B    B    B B        B B B       B  B      B    B        BB        B 
         B        B       B  B     B B   B B BB B          BB B    B BB  B      B      B             
B              B       B  B  B    B   B B       B          B B  B   BB     B B      B  B           BB
  B  B          BB    B      B  B   BBB         B B   B        BB  B                B            B   
 BB   B              B      BB  B B  B   B        B  B   B B   B B               B              B    
                 B B       BB         B B    B B B B                B  B  B     B B   B        B     
        B     BB  B   B       B B  B     B        B      B                 B          B     BB       
     B B      B    B    B      B B   B B       BBB    B      BBB B        B B    B B    B  B    B    
BBB       B     B      B    B B B           B  B                B  B  B   B  B     BB                
      B    B   B         B      B B   B BB B  B                          BB  BB  B                   
A        B  B  B B  B      B  B          B  B             B           B  B        B    B       B     
 B  B                        BB  B               B     B      B      B         B  B         BB     B 
  BB     B        B   B         BBBB      B  B     BBBB  BB    B  BB  B   B   B B       B   B        
  B         BBB    B       B   B BBB B            BB     BB B   B B         B       B B   B B        
      B    B    B    B     B    B  B                 B BB    BB                   BB    BB BB      B 
   BB  B   B BB   B                       B                    B         B  BB               B    B B
   B                       B            B  BB   BB          BB       B      B     B                  
     BB             B   B    B  B   B                     B BBB  B                    B  B        B B
 BBB B       B   B       B       BB    B      BB                      B      BB   B B   B            
      B  B    B   B                   B         B   BB  B        B     B     BB    B         B    B  
   B B         B      B   B   BBB B       B B   B    B  B  B    B     BB B      B            BB      
    B B    B     BB    B       B          B   B BBB    B        B B              B  B  B       B BB B
     B  B BB    BB      B B       B   B            B   B          B       B    B   B  B   B          
 B   B     B   B  B   B    B          B   BB     B         B                            B    BB   B  
    B      B     B B B   B  B   B  B B   B           BB B      B      BB    B  B B       BB B   B B  
 BB    B B                   BB B  B  B  B  B   B             BB    B B     B       B  B  BBB B      
B     B     BB B  B  B            B                B           B B             BB   B BB B    B B    
BBBB   B       B  B    B B              B          B  B    B B  B  B  B     B B                 BB   
    BB B     B     B BB   B    BB                  B    B            B                 B   B B BBB B 
   B      BBB   B BB  B  BB         B  B  B          BBB B     B  B B        BB      B     B     B B 
  B         BBBB   B            BB    B    B    BB BB    B              B   B B B  B              BB 
B   BBB        BB     B     BBB            B  B   B  B  B        B  B      B     B         B B      B
B   B    BBBB     BB  B          B              B                        B     BB BB   B BBB         
  B   B      B B B        B    B  BB B      BB      B  B BB            B        B B              B   
 B      BB  BB  B  B B  B B B  B       B            B  B                B      BB   B    B    B    B 
B          BB   B B          BB BB  B   B B   B  B   BB   BB   B B     B      B B B B       B        
        B B B    B             B             B B    B     BB   B    B      B  B      B B        BB   
 B    BB  B          B B B B  BBB         B B  B BB              B   B B B     B   B      BB B     B 
     B B  B  B BB BB    B     B   B   B   B         BB  B    B   BB          B    B         B       B
        B         BBBBB    B  B B B      B      BB      BB BB        B   B         BB     BB B   B B 
         B       B  BB                   B  B  B B   B   B     B           B B   B B      BBBB  B    
              B       B             B      BB B     B     BB      B   BB B B     BBB  B   B B B  B   
   B        B     B       B  B  B   B        B  B     B       B     B   BBB   B B    B     B BBB     
                   B             BB      B     B     BB   B          B             B  B  BB B        
 B B B           BB     B          BB          B   BB    B  B B  BB B  B    BB B  B B   B    B      B
  BB       B   B    B     B         BB B          B        B B BBBB B    B  B      BBB B B    B  BB  
    B          BB B   B   B               B B         B      B B       B  BB  BB           B         
B  B    B B   B                     BB   B    B B   B      B   B  B       B     BB               BB B
    BB  BB    B        B   B   B B        B B B B           B                   B B   B      B    B  
     B BB  BB B     B BB  B       B  B  B BBB  B   B    B       BB             B B         BB        
      B             B           B              B  B      B    B              B        B       B  BB B
 B        B             B  BBB   B               B    B  B B         B      B  B  B            B  B  
  B  BB    BB B  B   B B         B    BB   B  B  B  B           B    B          B   B B B     B BB   
 B        B          B               B       B B  B B                           B B B        B       
          B         B         B  B             B B    B  B   B       B    BB         B B      BB    B
               BBB        B  B   B        B      BBBB    B           B    B B       B            B   
B  B     B          BBB    BBB     BB      BB    B B    B     B  BB  B      B  B           B  B  B   
   B             B B             B B B   B      B B   B      BB             B B BB    B   B       B  
      B       B        B  B             BBBBB    B BBB        B B B    BBB     B    B B              
      B     B          B  B         B    B       BB          B  BBB BBB      B    B B      B     B   
   BBBB B          B      B    B B     B          B    B     B B  B  B   B B  B      B               
            BB      B              B          B B    B  B            BBB   B      BB  B   BB B  B    
             B B  B      B              B  B B  B  B       B  B BB   B B  B       B  B   B   BB      
 BBB           B                        BB  BB    B  B      B  B       B   BB B    B      B          
 B           B          B    B   B   B B  B                 BBB    B B    B            B    B  B   B 
BB      B B  B  B B B  BB             BB   BB B        B       B  BB               B         B    B  
    B B          B  B  B   B    B      BB B     BBB    B    B  B                     B B    B        
      B  B    B    B B    BBB                       B B B    B           B          BBBB     B       
 B         B         B  B   BBB B          B B        B  B B          B B      B     B B  B BB B     
 B    B       B       B  B      B      BBB  BB   B BB  B            B    B   BBB      B    B         
B B        BB  B     B    B   B    B B              BBB      B        B      BB   BB         BB    B 
B   B   B  B   B      BB     B  B  BBB B   B  B   B       B    B BB   B           B    B     B   B   
     BB B     B             B  B      B B   B         BB     B B   BB      B   BB BB          B      
 BB    B            B  B  B  B   B      B               B        BBB  B        B BB     B B  BBB B  B
    B                 B    B BBB                  BB      BB B   B  B       B   BB    B   BB         
  B     B    B       BB   B   B BB BB     B   BB            BBBB          B               B      B  B
          B     B   BB BBB                 B      B               B      B B  B     B B  B         B 
   B B        B      B B       B           B B  B   B     B B               B   B          B B  BB  B
  B    B                  B BBB  BB     B  B B   BB B      B    B  BB   B B  B  BB  B B    B   B    B
 B   B  B   B       B     B       B  B BB             B           B B               BB   B B B     B 
   BBB       BB  B BB    B      B B  B B  B   BB   BB  B BB          BB         B    B B B BB B BB   
       B    B  B  B        B  B  B       B         B BB    B    B  B   B B     B    B    B B B   B B 
 B    B         BB    B  BBBBB  B        B B  B B BB  B    B  B      B      BBB         BB   BB    BB
    B         B     B   B B B BB  BB        B B       B     B  BBB         B        B  B B   B   B  B
B  B                B       B  B  B          B B  B    B     BB                BBB    B B            
B   BBB         B           BB                       B    BB BB  B                  B       B        
 B B  BB   B    B  B B  B  BBB     B   B  B   B       B B       BB           B       B               
 B BBB BB       BB    BB  B B        B              B       BB  B              B   B  B  BB        B 
                  B               B  B  B  B B B    B  B        B B  B        B B     BB       BB    
    B    B        B            B B B                         B   BB  B B    B     B   BB   BBB      B
           B       B              BB  B  BBB          B                       B B       B  B  B      