   B  B     BB  B       B    B  B  B     B B               B B    BB   B B  BBB           B    B     
         B     B B      B                               B     B   B B  B B              BB    B    B 
B    B     B    B     B        B  B BBB   B  B      B B     B         BB   B B  B        BB  BB   B  
    B B  B B             B B     B   B   B   B  B  BB       B           B BBB  B                B B  
   BB     B B B    B B       BBB                       B         B    B   B     B B B B   BB B     B 
   B         B BB BB              BB   B  B   B   B B     B        B          B    B  B B           B
B               B         BB       BB     B          BBBBB        B  B    B      BB    B  B  B   B   
B   B   B         BB B   B B                     B           B        B B            B  B    BBBB B  
          B      B       B            B B B B              B B        BB             B  B    B       
 B  BBB  BBBB          B BBBB BBB B    BB B B B   BB        B    B         B                  B   B  
    B   B B  B    B       B         B B     B  B   B         B B B     BB      BB   B   B        B B 
     B B        B         B   BB  BBB  B  B  BB  B                     B B      B     B  B   BBB   B 
   B                B           B      B B B          B         B              B B   BB      B B    B
  B                   B   BB          B B  BB    B     B  B     B BB BB      B       B    B   B  B BB
B            B         B   BBB     BB         BBB     B B B   B   B          BBB               B  B  
            B         BB B BB   B      B      B       B         B        B  BB        B     B        
   B B  BBB       B          B     B  B B          B              B  B          B B      B      B BB 
 B    B   BBB B        B         B      B       B     B       B          B             B  BB   B     
 B               B      B      B BB  B     B           BB         B   B     B B    B            B    
    B B B  B         B         B   BB B      B B       B    B                B       B BB B       B B
     B        B B B       B             B  B  B  B B B BB B   B                   B  B    B   BB   B 
     B BB                    B      B   B           BB B       B   B B B  B        B   B B           
B B             B  BB    B  B    B B B B BB B B           B  B  B B   B     B   B BBBB             B 
BB  B                      B B           B  BB      B  BB           B BB B                 B    B    
BB    B         BB                  B   BBB      BB  B   B    B    B    B         B             BB BT
B BB                 B       BB BB           B      B       B  B         B  B   B      B  B BB    BB 
 B B        BB        B     B  B    B   B        B       B B   B   B     B   BBBB B          B       
B       B    B  B    B       B B    B       B B  BB B            B   B  BB    B    BB                
B  B     B   B          B  B B  B  B            B                B      B    BB    B BBBB  B     B   
   B B      B B       B       B        BBB   B      B         B      B     B        B  BB          B 
   B AB        B    BB     B    B      BB   B         B B    B   B B                   BB  B         
   B B  B                B      B  BB  B   BBB BBB  BBB B               B   B      B       B         
  B BB   B      B  B     B           B                B              B      B B BB         BB     BB 
  B         B        BBB B B B  BB  B  B      B     BBB    B        BB B              B    B  B      
  B B        B  B B BB     B  B  B    B    BBB B              B       B                          B   
  B      B B    B B             B     BB        B  B B       B B   B      B        B  BB       B   B 
 B      BB  B  BB  B           B  B    B        B  B  B           BB      B B                B       
 B       B  BB                      B   B    BB  B       B          B    B B B B  B   B    B      B B
BB       B B    B B  BB    B B BB        B              B        B B                 B   B B      B B
B B B      B    B B           B   B     BB     B    B   B            B B       B B    B        BB    
 B       B   B B     BB   B BB B              B B       BB B     B B      B     B   B  B          B B
B B  BB    B B        B        B      B BB   B   B    B           B    BB B   B BB   B  BB  B  BBB   
                   B   B   B B   B       B B    BB  B    B              B   B       B       B  B     
B B     B             BB   BBB      B    B      BB       BB      B   BB  B    B   B  B    BBB       B
 B B B B B B       B  B                    B BB    B         BB BBB   BB B   B     B    B    B B     
B   B   B   BB      B   BBB        B   B B B B   B      BB       B  B          B B  BB    BB   B     
    B           B            B   B  B            B B B                             BB B     B  B     
  BB   B    B  B B  B    B                    B       B      B          B             B              
             B    B       BB   B     B      B       BB     B    B    B  BBB   B        B         B B 
    B  B    B  B         B  B      BB   B B   B B  B    B     BB   BB B     B B  BB B BB B   B       
    BB      B   BBBB     BB   BBB    B       B     B   B B    B       B      BB      B      B  B  B  
  B    B BB   B  B           B       BB    B  B BB                   BB          B B              B  
B  B      BB     B   B       BB B BBB   B  BB  BB    B  B   BB       B                B  BBBBB    B  
       B   B  B      B B       B      B         BB   BB  B B     B B B B  BBBB              BBB      
 B   B      B B B B        B         B  B      B     BBB   B    BBB                         B  B  B B
  B   B       B  B              BB  B B         B       B B B   B    B    B  BB            B         
  B                B   B    B          B B     B        BB B   B B  B  B    B     B       BBB       B
   B          BB B BB       B        B       B      B         B    B  B   B  B   B    B    B       BB
B  BB BB B        B    B  BB  BB      B    BB                  B   B      B     B      B B           
B    B  B    BBB     B  B   B  B                BBB B    B                  B   B B B B B B BB B   B 
 B        B    B     BB B     BBB B B     B         B   B        BB B                   B B    B     
   B B  B              B BB  B B                         B        B B   B              B      B   B B
      B   B                    BB     B  BBB B    BB B    B B     B    B   BB                BB      
B     B B  B                B   B   B                  B      B          B B B B B           B      B
            B    B     B B     B  B           B           B B     BB        B           BB       B B 
  BB                              B  B    B      B B B   B    B       B B      B  B           B B BB 
      BB    B       B   B        B   B  B     B     BB      BB            B  B           B  BB       
  BB                B  B      B  B  B    B B   B   B   BB       BB  B      B        B  BBBB          
B  B      B    B          B            B   B  BB B       BB  B  BB    B   BBB               B  B    B
B                 B     BBB BB   B         B               B       BB    B      B B  BB   B          
        B             B      B    B     B  BB    B             B          B  B   B B B B   B        B
    B  B  B             B    B              B  B     B    B     B  B      B         B    B B   B    B
B B      B       B    B       B      B  BB     B    B              B  B BBB  B                      B
 B B B  B  B B   B        BB B BB      B             B      B         B   B    B   B               B 
  BB    B  B     BB B      B B    B      B         B B      BB    BB  B     B       B  BBB B       B 
  B B   BB  B     BB         B   BB   B  B B B      B B B B    B        B       B    BB     B  B     
         B          B B  B    B    B                B  B  B   B BB       BB               B   B   B  
                                  B     B B   B B        B BB B     B             BBB       BBB  B B 
 B    BB  BB  B                B        B            BBB BB BB   BB B  B    BB B    B   B   BB B    B
B    B       B      B         B B    B   B   B            B          BB BB   B    BB      B       BB 
   B BB B      B         B B  B  B     B B          B     B     B       BBBB            B       B    
  B B    B  B BB B   B B  BB         B        B BB  B       B   B            BB   B   B     B       B
B B B    B B BB               BB  BB     B            B        BB   B              B  BB       B     
B  B    B B  B   B      B      B  B B B B     B  B B BB        B  BB    B B    BB   B B       B      
B B        B   B        B          B       B BB B   B       B BB    B    B      B B        B         
   B B  B    BB          B          B      B            BB           B B                B   B  BB BB 
 BB B      B      B     B   B  B         B     B B  B       B B B     B        B  B   B  B B         
      B    B      B  B   B  B   B        B   BB         B    B   BB   B     B             B        B 
BBB     BB        B   BB B B B B         B B   B            BB  BB    B BB   BB B               B    
           B   B        B B         B              BB    B             B  B  B  BB       BB   B   B B
          B  BB   BB         BB  B BB         BB B    B             B     B  B B          BB B  B  B 
                B        B  B   B BB  B    B      B                 B B B     B    B   B    B   B B  
B     BB  B B   B         B     BB          BB           B   B     BBB                     B   BB   B
  B     BB B B   B     B      B B   BB      BB      B B                  B   B    B   B       B      
B BB          B   B      B     BB B      B    B       B B  B B         B  B   B          B B         
                 BB  B          B     B   B  BB              B  B  B       B B       B       B B  B  
B   BB           B     B       BB   B    BB   B   B     B              B      B B  B B    B     B  BB
 B            B  BB BB          B   BBB   B BB       B           B  B BB  B         BB          B   B
B    B   BB    BB    B          B  B  B   B    B   B  B      B B BB B  B  BB B B   B                 
       B                 B               B  B     B          B      B      BBB     B           B  BB 
     BBB         B         BB B    B  B   B        B         B  B   B        B B B B   B         B B 