          BB B     B B  BB                 B    BB   B  B     BB     B     B     B  B   B      B     
     BB  B B      B      BB   B BB       BB  B B          B     BBBB         B  B BBB     BB         
  B           B       B   B B    B        B B B       B   B       B   BB       B  B  B B  B   B B    
          B   B       B BB  B        B      B     B     BBB     BB    B  B       B  B           BB  B
   B    BBB      BB    B BB B     BB           B   B              B           B        B  B  B      B
    BBB  BB    BB    BB    B B    B  B    B                   B B       B B       B B  B   BB B   B  
  B     B     B      BB    BB     B    B BB B     BB B B B B  B B BB    B BB        BB     B  BB     
 B BB BBB    B  B        B         B  B                    B     B            BB   BB   BB     B B B 
  BB  B B    B BBB    B  B  B B     B BB B    BB  BB            B             BB     B            B  
                    B        B   B B                   B   B    B   B  B B  B   B    B      BB  B    
 B   B B  B     B B B       B       B   B     B B             B B     BBB             B   B  B       
         B  B B    B  BB   B  B    B    B B   BB     B  B                 B   B  B      B            
B          B        B   B B   B    B   B   B     B   B B B  B   B       B    B   BB      B   B    B B
         B  B           B      B B  B      B          B  B  B   B     B   B      B B  B     BB  B  B 
 BB       B BBB   BB     B     B       B B       B     B         BB  B             B       BBB  B    
BB           B   BB   B    BB  BB  B    B    B      B   B   B   BB     B  B BB B  BB        B      B 
 BBB               B                      B       B       B     B B B           B   B B B  B   BB    
             B      B          B      BB   B           B   B      B   B  B      BB     B        B  B 
BB B BB        B        BB  B B   B BB    B     B                    BB B  B     BB    B  B  B       
     B  BBB   B   B               B    B BB    BB   B  B  B    B    B       B     B    B B           
B  B B   B                    B B          B  BBB  B    B B         B          B    B   B   BB       
B      B     B     B  B  B            B  B  BB BB    B   B B        B  B  B                  BB      
 BB     B     B B            B B             B     B    B  B            B B    B     B     BB        
 B B                                  B   B      B         BB        B          B           B   B  B 
     B   B            B     B    B   B     B       B    B  B             B B     BBBB   B    B       
                     B  B     B     BB   B     B B        B       B  BBBB       B B  B  B      B     
B   BB B                    B      B       BB   B B B B      BBB BB   BBBB BB   B B   B  B           
 B   B  B BB       B    B     B      B  B      B B      B  B        BB    B    B      B          B  B
 B    BB   B       B B   B B          BB      B     B   BB                        B  B    B  B      B
  B A  B  BB          B BBB     B    B    BB BB       B  BB  BB  B  B    B    B           B    B     
B B   BBB      BB     B     B B  B   B B  B      B      B  B     B      B B  B        B    B         
 B    B     BB B    B    B B  B B BB     B BB             B          BB  B B  BB        B    B     B 
          B   B  B    B B B   B         B     B    B    B    B                       BB   BBB  B B  B
     B    B     B                                 BBB B    B          B           B  B       B     B 
    B             B    B  B B     BB  B  B   B    B  B  B          B B               B    BB   B   B 
 B         BB BB      B B                  B          BBB            B    BBB B         B B       B  
      BBBB      B B     B         B B   B  B B      B    B                 B     B     B     B B     
            B                B   BB B B     B      B     BB      B      BB           B   B  BB      B
B        B   B     B  B      BB  B B    B         B     B      B     B      BB BB     B              
BB  B  B     B   B             BB BB    B        BB                       BB   BB  BB  B B  BB    BBB
  B B   B    B     B      BB              B            B       BB  B              B BBB     B  BB    
              B                   B     B      B     B  B                  B BB B        B        B  
    B B                B BB     BB    B     B  B   B   B   BBB B    B B   B      B               B   
B      B B                            B B  B  B                    BB           BB  B     B  B       
B     B             B   B         B     B B B B             B  B             B B   B            B BB 
B B B    B  B   B    B                  BB BB   B  B  B B        B         B BB B         B    B    B
  BBBB BB   BB       B B B         B       B  B B                B     BB      BB    BB    B         
  BB         B    B                  BB B          B B   B       B                 B B        B      
 B  B      BBB             BB BB  B          B           B       B B         BB    B  B   B   B    B 
 B            BBB  B      B    BB B  B         B B        B    B B    B   B B    B B           B B   
B B       B B      B  B            B           B      B  B          B   B   B        B B   B  B      
    B               B             B            B  BBBB     B   B B                  BB   B     B     
 B  B B      B    B                   B      B   B        B B   BB B  BBB   BB         BB            
   B      B B   B B   B        B                 B       B       BBBBB    B    BB    BB B      B     
B B    B B  BB B     B                   BB           BB   B B BB     BB                    B        
 B B    B B     B BB  B            B B  B  B      B BBB     B  B      B         B  B    BBB     B   B
     B         B    BBB  B   B   B     B   B     B           B          B         B   B      B BB    
            B B B  BBB B     B B        B       BBB  B B      B      B B   B      B  B    BB         
          B B   B  B   B   B   B       B     BBB    BB  B B   B   BB       BB   B BB   B     B  BT  B
  B      B                         BB          B             B       B                 BBB    B    BB
  B      B           B      B             BB   B  B  BB  B             B        B  B      B     B   B
        B     B          B     B            B  BBB B B    B B   B       B   B  B  B  B  B    B     B 
   B    B B       B      BB     BB        B      B  B          B  B    BB  B    B                    
B   B            B    B     B B  B     B          B                     B      BBB   BB B    B     B 
BB B    BB        B       B   BB        B       B           B B B   B B               B BB  B BB     
         B      B B   BBB    B         BB              B           BB  B   B  B          B B    B    
    B  BB    B  B        B  BB      B         B BB      B    B B  BB         BB              B B     
             BB   B       B      B    BB      BB     B         B     B        B       B B            
   B B       B   BB   B   B  B                      B  B   B    BBB   B             B        B      B
        B     B  B         B          BB   B B B   B   BB               BBB  BBBBB     BB   B B    B 
 B    B                 BB    B B        B  BB  B   B           BB BB            BB B  BB    B  BB  B
     B     B  B  B B              B B   B B   B  BB           B B                   B       B    B BB
 B B    B        B   B     B B  B    B                 B B            B   B B BB          B   B  B   
  B       B  B     B     B B                    B         BB              BB    B          B      B  
  BB B  B B  B   B      B  B B   B   B      BB      B            BBB   B  BB   BB   B BB           BB
   B B        B B            B B   BB    B  B B   B       B B    B    B B B    BB B          B BB B  
  B                B      B  BB    B           B      BB         BBB      B B               B B     B
   B    B B       BB          B         B B    B  B    B          B      B B      B              B   
            B         BB     BBB    B BBB     B B   B           B       B      B      B B       B    
     BB     B B             B            B                                   B  B     B        B   BB
   BB   B        BB     B   B    B    BB B     B B B BBB   B    B   BBB  B  B                B       
 B  BB B        B    B                            B    B              B     B BB          B   B    B 
              B       B  B  B  BB  B     B    B   BB  BBBBB B      BB  B BB B B B   BBB     B B B    
    B B       B       B         BBBB B             B      B B B    BB  B       B B                B  
   B           B  B  B       BB             B    B            B          BBBBBBB    B B B       B  B 
 B     B   B   B       B      B             BB   B B BB B        B    B    B       B  B     BB      B
  B       B                     B  B      B  B    B        B      B B    B  B  B B  BBB     B      B 
  B     B    B B           B   BBB           B   B  B              B        B                B   B   
BB  B   BBB    B          B       B            B       B    B     B                 B  B    B        
      B        B  B                         B                  B        B   B          B BB        BB
   BB  B    B        B B        B          B   B        BB  B        B     B        B            B   
              BB B B    B  B     BB  B B  BB    B BB   B      B  B B                       B    B B B
   B BB     B    B                B     B  B B         BB  BBB      B  B   B B         B    BBBB    B
       B B       B         B   B             B           BB   B   B    B     B    B   BB            B
 B  BB                      BB    B  B          BB BB B            BBB  BB        B           B     B
 B    B      B   BB        B BB           BB           B  B  BB B      B   B       BBB      B        
B B    B     B  B       B        B  B                                B   B  B          B   B         
         B B  B    B  B      BB  B    B       B        B    B         B     BBB  B  B B       B  B   
     B    B B  B      B   BB B            B     B  B          B     BBB    B       B      BBB B    B 
         B  B B  B  B       B         B B   B B  B B   B BB   B    B     B       B    B B  B         
   B          B      BBB      B  B   B   B       B    BB    B               B  BBBBB  B     B  B     