      BB      B     B          B            B  B  B       B       B            B           B      B  
       BB B    B BB      B B BB B  B   B     B    B  BB B   BB         B BBB            B    B B B   
   B         BB   B B     B    BB B  BB           B   B B     B  B       BBB     B  B  B    BB     BB
  B B      B B   B   BBB  B       B   B    BBBB        B           B      B          B B             
   BB B   B   B  BB             B   B  BB         B       B    B    B     B     B     BB  B          
  B  BB                 BB   BB B   B              B               B  BB     B             B B       
    B       BB          BB  BB   BB  B B     B    BB      B     B        B         B   B BB B B   B  
    B             B                 BB              B        B B  B               B  B        B  B B 
BB   B          B  BB  BB                           B      B        B  B          B     BBB     B    
            BB       B  B     BBB  B   B    BB    B  B   B        B            B B               B   
     B  B   B    B BB     B BBB           B  B      B B       B B             BB  B  BB     B      B 
BB  B    B    B   B B  B               B      B    B   B B           BB BB    B      B    BB      B  
 B B B    B         BB B   B B   B            BBB      B     B    B                   B    B    B B  
   BB           B B     BB    B      B       B B    B   B      B       B BB  B         B   B    B  BB
    B      BB B     B  B B B    BB   B  B   B  B B   B    B B   B     B  BB   B  B             BB    
 B  B         BB  B          B B BB    B            B B B       B       B  BB             B  B     BB
      BB       B  B           B   B      B B       B  B B            B     B   B    B      BB   BB   
    B       B    B         B     BB  B     BB           BBB B          B      B     B      B     B B 
    BBB   BB  B  B  BBB B      B     BB   B        B       B     B        BB        B B B  B BB      
B           B      BBB B    B     B B  BB    BBB  B    B    B       B B B B  B   B         B      B  
 B     B        B BB            BB     BB   BBB  B BBBB B     BBB              B                     
        BB     B   BB   B    BB      B   B B   B     B              B    B        B B       B    B  B
B   B  B   BB       B BB BB B  B B B      B      B     B    B      B    B             BB     BB B    
     B    B    B           B        B                     B B             B B   B   B  B  B   B  B   
  B    B B  B    B B  B   BB  B BB B           B       B           B B         B        BBB   BBB B  
  B     B B   B   B   B    B  BB      B          B B      BB  B   B     B B   BB   B      B          
  BB   B  BB B     B   B              B      B            B              B                   BB  B   
  B      B       B      B      B  BB   B                      B      B          B   B  B   B         
B   BB            BB   BB                BB      B B      BB B   B     B BB B BB   B     B  BB  BB   
  B A    B     BB   BB    B  B B B        B        B  BBB B  B  BB  B         BB  B     B     B B   B
  BB   B B                  B B B B  B   BBB            B     B     B B  B  BB    B     B BB     B   
   B        BB BB    B   B     B  B        BB    B     B B            B              B     B         
         B  B   B         B   BB   B BBB  B  B    BB    B      B B    B       B        B     BB      
  B        B    B       B     B     B     B  B    B   B   B  B     B   B                             
B          B    B B B B          B  B     B           B   BB    B  B           B  BB   BBB         B 
      BB  BB BB     B  B  B      B   B   B    B   B      B BB B  B               B          BB       
   B            BB      B      B        B              B   B  B     B  B         B     B  BB     B   
  B      B B     B  B   BB         B       BB      B BB           B     B     B       B              
      BB   BB    BB         B   BB   B BB     B   BB                     B             B       B B  B
             B   BBB        B          BB   B B B B   BB  B                   BB         BBB     B   
     BBB B  BB       B       B    BB B          B                       BBB BBB    B           B     
   B                     BB B  B B          B  B  B        B       B            B B B      B  BB B B 
  B        B   B  BB      B       B   BB                     B B    BB   BBB  B     B              BB
   BBB  B B  B   B B  BB     B           B    B    B        B  B            B       B B  BBBBBB      
 B                   B    B    B B B          B         B     B    B   B           B      B   B      
    B B            B   B  B B        BB B B               B     B            B         B   B    BB   
BBB B   BBB     B B        B  BB        B  BB B   B B   BB     B       B     B B  B                B 
B       B B           B   B B       B B  BBB B   B   B            B   B     BBB                      
                 B B B    B  B   B      BB B   B       BBBB   B          B      B          B B   B   
   B B         B  B  B B B   B        B  B       B   B       B B B  B  B         B   BBB            B
 B     BB     B B   B         B B   B                      B                    BBB  B         B B   
B       B  B    B     B B   BB      BB            B B                     B B    B    B      B   BB B
 BBBB     B    B    B           B          B  B     BBBB BBB  B   BB    B  B             B    BB     
BB         B            B B B    B B  B        B   B   B    B  B   B B         B   B      B      BB  
        B    BB B   B           B  B  B  B  B    B         B  B BBBBB B B          B  B      B B  B  
  B        BBB  B BB  B B     B     B   B   B   B   BB       B    B  BBB B    B            B        B
B  B        B  B       B   B            B    B B  B     BB        B     B                 BB   B BB  
B B          B        B    B  B   B       BB     B        B     B       B       B  B  B              
     B            BB     B B   B     BB B   B  B            B     B                       B   B     B
            B B     B  B BB   BB     BB    B    B    B         B           B B  B  B               B 
   B                 B BB    B      B                 B   B  BB      B  B   BB   B  B    B   B    B  
 B  B  B  B B      B                B B  B       B   B B   BB   B BBB    BB B BB                  B B
                B  B   B  B   BBBB B BB B       B        BB B    B   B       B        B    B         
                      B BB   B       BB  B    B        B B  B                 B         B  B         
        B  B  B   B      B BBB    B B  BB B  B       B B BB   B             B          BB  B       BB
   BB B     B    B BB  BB  B   B B  B        B  B B  BB    B      B  B BBB  B     B                  
  BB   B  B  B       B    B  B    B         B B     B         B   B            BBB   B B       BB B  
    B      B             B      BBB                    B      BB  B      B    B      B      B        
      B B B   B  B       B     B      BB     B   B  B BB        B  BBB                      B     B  
   B B     B                    B                     B  B  BB    B        BB     B   BBB B   BB   B 
   BBBB  B          B   B  BB  B  BB   B     B  B          B   B     B   B  B   B     BB   B B B     
 BB     B  B B  B    B BB  B       B     B  B     B B     B             B      B    B  B     BB   B  
            B    B  B   B                     B    B  B   B     B           B           B            
          B    B    B  B BB        B           BB    B B BB   B B  B      BB    B          B  B   B B
     B  B  B  B  B  B  B     B            BB   B            B    B         B     B     B           B 
     B  B      B BB          B   B        B B      B  BB       B B                B   BB     B B     
 B   B               BB B   BB B            B      BB              B B B   B           BB  B    BB  B
  B   B B   B   BB      B B  B          B   B   B           B   B          BB       B         B     B
       B    B B  B    B  BB      B   B           BB BB  B           BB  B B        B          B     B
     B B          B  BB      B          BB  B                            BB      B      B            
 BB    B               B                BB  BB    B B  B  B  B    BB   B  B         BB B  B          
     B        B B               B      B   B    B   B B                B B   B   B  B  B B      BB   
   B  B         B      BB B        B      B    B BB    B BB                         B                
   B   B  B   B              B       B B         B                 B  BB     B             B         
BB           B          B     B        B B            B      B  BB      B B    B B         B    B  BB
         B B  BB     B             B         B    B            B               BB  B       BB        
   B   B          BB   BB  B   B B           B   B    B     BB    B B   B     B   B  B     B    T B B
B     B    B           BB B B  B  B     B      BB   B BB   B             B  B  B  B B   B B          
      B        B         BB      B BB    BBB   B BB    BB       B       B  B    B       B            
 B           BB            BB  B      B B   B       B B              B                 B BB      B B 
BBB          B B B     B            B   B     BB B             B     B   B           B    B  BBB BB  
    B B B  BB BBB  B B     B     B             B  B  B         B              B B B BB           B  B
B       B          BB      B   B    B      B  B   BB   B    B             B B   B          BB B B    
  BB               BBBBB B     BB    BB          B     B    B     B            B   B BB        B BBB 
B    B  B      BB       B          B B B   B                    B BB  B   B      B B  BB   B   B    B
    B  B     B         B        B      BB         B          BBB           BB     B  BB   B   BB     
  BBB   B          B     B  B  B         B B       BB    B     B      B  BBB        B B              
    B          B B B      B  B  B    BB          B       B                    BBBB B         B       
                          B B      B B B    BB B       B   B              B  B  B B BB        B   B  
         BB      BB B     BB      BBBB       B B    B        B  B       B     B     B B              
 B   B            B   B  B        B                  B  B  B  B     BB  BB              B BB  B B    