B   B     B              B     BB B   B    B      B                             B    B  B  B  B      
     B  B         B            B            BB        BBB               BBBB            B            
    B     BB   B    B  BB    BB   B B      B     B    BB   B          B  B B      B     BB    B      
    BB    B B    B               B    B         B   B              BBB  BBBBB  B       B  BBB B  B B 
B                B   B             BB    BB B B         BB   BBB          B B   BB  BB  BB B   B     
   B          B      B    BB B      B              BB      BB B BB    B BBB    B B       BB  BB   BB 
B    BBB           B                BB    BBB      B   B  B   B        B BBB         B B BB          
   B B          B  BB  B  B BB  BB B          B   B BB    B        B                             BB B
  A  BB    B        BB B                   B B  BB  B      B                      B    BB  B  B B    
    B  B  B  B B  B   BBB                    B    B       B B  BBBB  B    BB  B             B B B    
  B  B BB    B       B  B    B    B B       B           B  B     B    B   B  B   BB B      B        B
    B   BB      BB B           B B              B   B   B                 B       B      B B        B
      B    B   B    B  BB B   B   BB B    B BB  B       B B    B B               B       B  B B     B
 B   BB        B BB BB     B        BB              BBB    B          B       B     BB  B            
               B   B                B    BB              B     B    BB                     B  B B B  
          B         B   B  B    B        B          BB    BB          B   BB           BB  BB B B    
  BB       B       BBBB   B     B B        BB  BB                    B   B BBBB B B  B    B     B    
B                  B    B    B   B B   B   B  B BB    B B B B B B                 B   B    B  B  B   
BB      B   B              B           B B         B  B BB          B  B    B  B               B B   
 B B      B                       BB     BB     B   B       B   B  B   BB B     B  B               BB
  B      B B         B B     B    BB B     B    B              B         B BB     BB               B 
  B B    B               B       B     B     B   B          B    BBB   B  B  B  BBB       B  B    B  
 B   B   B   B BBB          BBB     B      B    B   BB        B   BB     B   B    B   B    B  B      
B B         B  B  BB B        B        B B B   BB B   B    B    B     B B      B   B        BBB      
   BB     B            B                                                 B     B BB  BB   B  B  B   B
                 B          B          BB        B          B    B    B   B   BB BB B            B   
B B  B    B   B   B    BB B   BB   B    B               B B                B    B B            BB  BB
    B   B B     BBB   B   B      B   B BB    BB    B   B   B        B B B B B             B        B 
  B B B     B    BB    B        B       B    B B BB     B  B   B    B                B  B         T B
   B B      B B           B           B    B    B            B        B                B BB   B  B   
B  B     B B               B         B    B                B    B        B  B B B           B      BB
    B        B     BB   B    B       B  B B               B BB           B       B    B        B   B 
  B        B         B     BB     B     B  B       B  B  BBB  B B   B          BB   B    BB  B       
B  B      B B B     B          B     BBB   B B          B   B  B B      BB    B  B  B         B   B B
      BB  B              B BB   B                   BB     B B  B       B  B   B  B        BB    B   
B B            BB        BBB          B              B       BB    B      B BB  B       B            
  B    B    B   BB         BBB                B   B BB    B            BB  BB   B     BB            B
         B    B   B   BB   BB   B  B                  BBB  B     B B B      B B  BB B            B   
 B         B     B          B    BB  B     B      B   BB       BB      B         B  BB      BB    B  
  B   BBB       B         B              B             B B BB                           B B B BBBB   
  BB BBB B    B   B  BBB         B          B     B       B B B  BB              B   B       B       
        B    B B           BB               B    B B   BB B    B BB BB     B     B     B   BB   B BBB
   B      BB           BB B B  B      B    BB  B  B                        B  B BB     B      B      
 B    B   B            B      B B    B B  B B      B  B   B  B      B    BB   B                 BB B 
  B     BB BBB   B      B    B     BB  B  B             B  BB       B   B      B            BB      B
   B  B              BB       B   B                 BB         B         B  B       B             B  
  B B                 B B    B BB B      B            BB           B    B            B            B  
  B    B  BB                  B       B         BB           BB             BB     B B  B   B      B 
  BB  B     B   B  B    B  B   B     B   B                     B         B     B    B      BBB     BB
          BB  BB   B  B   B         B B     B        B   B             B  BB       BBB   B B       BB
    B B    BB     B       B B B     B        B                      BB  B       B B        B    B BB 
             BBB          B     B  B     B    B   B     B  B        B         B B  B      B         B
       B       B    B            B        B                B               B  B B              BB BB 
B     B  B  B      B   B    B B       B     B      B          B  B     B     BBB B B  B BB B         
             BB B    B      B       BB    B        B      B      B B     B  B BB        B   B        
   B  B B     B B         B      BBB  B    B    B     B     B    B              B               BB  B
   B       B B  BB    B B       B      B    BBB  B BB B      B  BB    B B      B B        B BB   BB B
  B  B          B BB  B B             B      B  BB     B   BB         B     B   BBB          B    B  
      B    BB     B     B  BB B  B    B   B B         B B    B           B            B     B BB BB  
       B       B BBB      B   B     BB                  BB                     B  B         BB  B  BB
B   B B   B B                                    B  B B    BB   BB         B   B      B           B  
      B  B B  B    BB    B        B              B    B      BB  B  B       B  B         B B B       
        B    B       B                   BB       B    BB B  B  B B B B B            BB B   B        
     B    B          B  B B B             B B       B    B  B B B B        BB     B   B    B  B      
  BB   B B B  BB                       B  B    B  B  B             B      B    B    B B B BB BBB B   
  B   B   BB    B   B           B    B              B                B  B     B  B  B          BB  B 
   B                  B B     B   B      B B B BB    B     B B B           B           B  B B   B    
  B             B                       B     B  B     B           B            B    B B       B    B
         B         B B       B      B   B B   B         B   B    BB    B        BB   B   BB       B B
   B   B   B B B   BBB          B B     B      B    B    B          B B  B B        B  B      B B    
     BB  B  B     BB    B      B B    B     B     B           B     B         B       B     B BB B   
            B B             B  B    BBB B B     B  BB    B   B B                B     B              
 B B    B  B        BB    B B    B    B BB       B    B  B   B  B            B BBBB B  B   B        B
B  B B     B  BB   B       BB   B  B    B       B    B      BB B B   BB     BB   B     B  BB  B     B
      B        BB                           B    BB            BB  B B B               B    B B B    
   BBB  B     BBB B B  B   B B    B       B   B     B  BB        B          B    BB   B      B  B    
          B  BB     B B B       BBB B    B    B               B B        BB             B       BB   
   B     BB B  BBB             B     B         B     B         B     B B      B  B  B B B  B   B B   
B      B  B        B  BB   B  BB   B    B B      B              B      B       B               B B B 
   B B            B  B B     B B   B     B  B               B  B           B         BBB    B   B    
B   BBBB       B       B B       BB    B     B  B B       B       B B  B   B   B              BB B   
BBB     B   B     B                BB B        BB    BBB B  BBB B B         B   B      B   BB        
   B       B  B    BBB   B   B  BB B B   B     B  B BB         BB   B            BB      B          B
   B B B           B            B             B                           B B    B      B     B   B  
  B  B              B B      BB     B           BB  BBB     B       B     BBB B BB  B   B B    B B   
   BBB  BB B B       B            B      B B     BB      BB  B    B B   B BB    B B  B   B           
   B B  B        B      BB         B  B B                   B   B         B    B      B   B    B   BB
     B   B  BB                      B  B B     B B  B B   B B B   BB         B  BB B    B           B
    B   BB               B B      B B   B   BB   B BBBB   B   B              BB  B     BB  B B     B 
  B      B     B   B  B  B    B     BB    B  BB    B    B          B     B         BB         B      
          B   B B            B         B B    B      B  B  B     B  B  B  BB     B   BB   B BB   B   
   B  B      B   B   BB   B      B    B              B B           BB  B  B       B B    B B   B     
 B   B B B          B B      B     B B  B    B         B        B    BB B  B      B   BB BB     B    
        B       B                             B            B  B B      B        B   B  B  BB    B    
         B        BBBB                 B   B   B B B         BB     B              B      B          
  B    B     B B  B B    BBB      BBBB    B        BB B BB       BB     BB B B  B    B  B   BB       
          B   B  BBB  B   B                 B      B      B B B      B B       B  B  B  B    B   B   
   BB B  BBBB      B  BBB  B  B        B  BB  B      B        B B        B      B      B       B B  B
BBB    BB BB    B      B           BBB    B   B           B   B B          B       B   B B  B     B B
    B                   B        B   B       B  B         B  B B B    B   B   B B               B    
BB   B B         B  B  B    BB                        B    B     BB     B   B        B B      B      