 B B  B       B   B   B    BB      BB B          BBBB   B       B      B          BB  B B      B   B 
      B     B      B   B       BB                  B    B    B       BB    B B          B     BB     
      B    B    B             B   B        B       B      B      B B  B                     BB  BB  B
    B B         BB  B          B   B  B B           B BB  B   BB B BB BB  B B B          B           
 BBA       B     B B   B          B   B B B    B         B                B      B BB  B        B  B 
   B B   B     B B   B   B             B   B        B       B      BB    B B       B B BBB   BB      
    B   B  B  B          BB        BBB BB              B    B    B   B  B    B   B       BB     B  BB
 B   BB          BB    BB    B    B      B B     BB              BB      B          B       BB      B
B    BB       BB     BB  B      BBB   BB   BB   BB            B        B     B    B   B      B     B 
 B    BB B  B          B    B B          B   BB B B   B             B   B B             B   BB B B BB
  B   BB        B BBBBB       B    B      B BBB B B B  B        B B B             B   B            B 
    B       BBB BB         B      B   BB   B   B     B B         B   BB    B    B    B  BB           
        B            B BB        B    B B  B           B      B    B  B        B    BBB     BB BBB B 
    B   BB    BB   B B            B    B B          BB BB B     B  B  B    B     B B B  B  BB   B  B 
     B       B    B   B  BBB  B  BB         B  BB   BB B        B   B BB   BB    B  BB     B        B
                B  B    B                 B       B    B     BB            B            B  B     B   
   BB   B     B   B                       B  B  B          B      B B        B B            B   B  B 
    B    B      B    B        B  B  B  B    B    B B              B  B     B  B   B        B    B    
     B B B     B           B   B  BB     B      B B      BB            B   B B            BB B     BB
  B  B                   B     B           BBB  B     B          B B B    B  B B  B   B         B    
B    B   B BBBB   B      B          B        B   BB  BB   B     BB    B            BB   B  BB        
B    B    B        B   B BB        B               B    B         B  BB   B   B          BB   B B  BB
B             B          B BBB  B         B B            B      B  BB          BBB   B               
  B  BB     B  B  B  BBB         B     BB  B       B          B      B B BB  B      B        B       
B B       B B   B BB   B    B B    B   B B             BB   B   B B          B      B    BBB  B   B  
   BB          BB    BB B B  B B               BBB  B B  B   BB   B         B               B  B     
    B  B B    BB         B  B              BB   B      B B  B   B        B          BB  B         B B
 B   B B  B B BBB                      B  BB B BB    B      B       B           BB B     B  B      B 
                        B B      BB      B    B          B    B       BB    B    B B B B  BB      B B
B BB       BB B     BB      B  BB  B   BB       B  B    B     BB    B  B      B        BB    B   BB  
     BB B   B      B       B    B B       B   B   B      BB  B B       B             B       B B    B
      B   B  B        B   BB                BB B       B B     B  B BB B   B BB    B          B    B 
    B             B  B   B B  B     B   B    B B     B                      B BB        B         B  
          B B    B         B            B    B B  B              B                  BB B  B B  B B  B
  B               B       B    B     B   BBB           B      B       B   B            BB    B       
          BBBBB  BB                B B    BB    B    B               B B   B           B   BB   B BB 
B        B B   B      B B   B   B    B            B      B           BB     B         B B   B      B 
  B        BB        B       B    B              B          B  B        B                    BB      
     B    B           B        B  B   B          B         BB  B        B B      B    B   B B   B  B 
    B    B    B     BB  B               B    B   B       BB           B B     B   BB B B    BB       
   B    B            B   B  BB     B B B  B B BB     BB    B  BB   B B       B B  B    B B  B  B     
  B                 B       B  BBB            B                          BB B   B B   B    B  B      
     B  B        B B  BB    B  B   B     B      B                    B   BBB     B  B  BBBB    B  BB 
     B  B B B  BB       BB       B         B    B                        B        B            B     
    B  B    BB          B  B B   B BB           B             B   BB          B   B   B       B B T  
              BBB   B          B           B B       BB     B BB                          B   B      
   B B B  B   B    B B B B B B B    BB           B    BB   B    BB    B    BBB   B        B   BB     
           B B           B B      B B BB  B       B          B        B  BBB   B   BB  B        B  B 
BBB   B   B    B   BB B    BBB BB       B B         BB  B       B  B B B  B  B BB B  B B         B BB
 B      B  B    B         B         B       B B     B B   B BB    B  B   BB B   B      B     B  B B  
 B       B  B  B  BB                        BB     B     B        B B  B B     BB     B   B  B   BBB 
      B   B B  B   B    B   BB     B        B         B  BBB B  B     B B B BB    B B   B    B  B  B 
      BB       B   BB       B  B    B      BB      B B   B      B         B BB      B    B    BB B   
    B B B  B B B         BBB       BBB                 B     B     B    B      B B      B    BB      
BB B        BB BB    B                 B B              B       BB                  B  B B      B    
    B B        B B          BBB B  B  B     BB   B           B             B B            B  B B   B 
         B         B    B         B      BB    B   B     B   BB    BB           B    B B B B       B 
       B         B               B           B     B  B  B       B B B B      B           B B     B B
        B    B  BB         B   B  B   BB      B            B        B         B     BB  B   BB       
                B B B   BBB     B      B            B      B B    B      BB  B      B                
 BB B        B B B  B  B   B  B      B   B        B   B B  B          BB   BB B B     B          BB  
   B                            B B B   BB                        B    BB B     B B             BB   
       B B B   B  B    B  B B  B B  B       B         B BB   BB  B          BBB     B      B      B  
    B         B  B B          B                 B   B             B   B                B    B        
          B      BB    B   B   B   B B             B     B B      B        B     B             B     
B   B     B  B BB   B       B  B       B B  B    B      B     BB    B  B B    B  B  B           BB   
B        BB    B     B  B                BB B   B BB B       B B B B BB    B         BBB             
B     B     B   B   B    B B  B       B     B  B   B     B          B   B    B        B BBB   BB     
     BB               B        B    BB         B B        B BBB     B B B      B   B    B            
B           B  B       B B       B  BB  B      B            B B B               B   B       BB  BB BB
  B                 B  B    BB B       B B         B B           B           B B       B    B    B B 
 B    B                   B           B                B      B           BB              B         B
B BB          B   B    B  B B         B    B B     BBB  B BB  B                B       B     B B B   
  B  B BB     BBB   B      B          B           BB            BB B   B BB  B   B    BB     B   BB  
            B BB       B B  B        B  B       B  B B          BB    B        B  B  BB          B   
    B  B           BB B     B               B B          B BB           B B B   B   B        BB      
 B  B   B B   B    B  B  B    B    BB      BB   B    B       B     B BB    B   B    BB      B B BB   
    B      BB      B B B  BB B   B   B B          BB    B    B     B           B        B   B      B 
BB   B   BB     B B        B   B  B  B  B   B              B    B BB    B   B   B                   B
                   B    BBB BB B     B B  B  BB       BBB B B   B    BB  B     B      B   B B  B     
 B B B  BB  B                B   B     B      B               B    B BB       B       B BB      B    
         B        BB    B    B      B  B B        B  B  B    B B B         B     B BB              B 
        B  B B       BBB       BB              B   B         B  B   BBB   B    B  B      B B  B B    
BB      B   B  B        B    B   B   B B  BB          B BBBBB       B   BB      B BB       B       BB
BB  B  BB  B   B             B  B B  B   B                      B   BB   B    BB    B  B         B  B
  B       B B    B  B      B    B         BB   BB     B B  BB B BBB     B  B            BB    BBBB   
  B  BB    B    B    B BB   B          BB      BB  B       B                 B         B   B       B 
  B B            B   B  B     B B B   B B     B           B        B    B      B B       B           
B     B B  B     B  B   BB    BBB  B    B                B        B     BB      BB    B  BB B B      
   BBB B             B                     B       BB      B    BBB BBB     BB B   BB    B     B     
 B      BBB B B       BB  B      B             B  BB        B  B B   B B B   B  B                    
      B   B     BBBB    B B  B     B B         B    BB BB  B   B   BB  B B     B    B               B
     BB B         BB    B         B B   B        B  B B        BB              B  BB   BB   B  B    B
  B           B B   BBB  BB        B  B BB     B            B          B   B   B                    B
  BB B          BB               B    BBB    BB     B B B  B        B    B B       BB B B        BBB 
B   BB           B  B     BB     B  B   B             B  B BBB               B    B          B   BB B
B    B  B      BB   B BB  B  B                 B      B        BB BB               BBBBB BB  B      B
   BBB B   B  B     B        B          B BB  B   B    B B B BB   B          B B    B        B    B B
 B B B   B  B B        BBB  BB       B        B B         B   B   B       B  BB  B     B             
      B  B B          BB  B          BB BB BB    BB  B   BB B     B  B  B         B B   B    B       
   B   B            B    B B            B  BB    B   B     B BB    B   BB B  B BB      BB   B B B BBB