 B       BB  B  BBB    B              B   BB BB                   B    B B B     B          B B BB   
  B  B  B           B   B B BB       B  B  BB    BB   B B   B   B         B B                        
B BB       B       B BB   B        B BBBB      B        B                               B     B  B   
                    B  B B    B             B     B               B  B   BB    B   B B  B  B       BB
      B  B                  BB  B BBB BB   B B      B B  B  B     B          B  B B      BB     BB   
        B           B        B    B    B  B           B       B    BBB           BB     B   B     B  
 B      BBB       B     B   B    B B           B      BBB B   BBBB     BB B     BBB BBBB   BB  B    B
B B        B      B     B    B B BB    B           B B     B   B              B BB      BBB    B     
B          B      B  B             B       B            B     BB  B    B B B                 B  B   B
    B  BBBB      B B B   B   BB       B B B           BB   B   B   BB        B B                  BB 
  BBBB BB BB B   B     B    B  B   B    B B B  B                    B         B BB            B     B
    B           B   B        B B  B               BB    B  B      B  B      BB    B   B BB B     B  B
      B    B  B      B             BBB     B         BB B        B       B         B    B     BB BB  
    B                 B     B      BB             B     B  B B     B B  B     B           B B     BB 
  BB          B        B  B  B B B     BBB  B BB       B  BB   B    B    B  B     BB  B           B  
       B     B  B   B     B         B       B BB                B B          B B  B  B B B  B   B    
           B     B      B      B    B          B     B     B BB     BB  B         B                 B
B   B BBB BB  B  B B   B   BB B B B                      BB BB B     B B BB   B       B     B   B    
     B        B     B   BBB   B           BB       B     BBB   B           B          B              
     B             B             B   B   B                                 B B           B B      B  
    BB  BB         B     B   B    BB   BB                    B  B         B  B B    B        B       
    B B   B    B  B  B          BB    BB B      B           B      B  B  B BB                  B    B
 BB               BB B  B         B  BBB          B   B B      B B          B    B        B B        
   B  B       B   BB B                B B B B  B BB   BB                    B B       BBB   B    B   
  B   B         B       B B   BB         B     B  B   BB       BB  B B      BB B                B    
 B   B         B   BB   B   B     BB       B     B   B BB   B  B BBBB B B  B  B      B B          B B
      B B  BB               B                B    B   B          B   B    B B  BB          BB      B 
          BB    B B   B      B   B             B         BB B     BB      BB    B    B   B BB        
          B         BB B    B  B                B    B    B    B  B  B        B                BB    
B   B      B     B      B    B         B  B  B B  B         B         B  B          B              B 
                    B     BB B         B B   B B    BB        B     BB  B  B           B   B B       
B B      B BBB   BB B    B    B     B   B   B  B   B B  B       B    B  B  B     BB  B              B
   B  B       B     BB    BB  BBBB  B      B        B B B    B   B B       B                      BB 
   BBB         B  B       B    B B  B   B BB    B  B   B    BB           B     B   B B   B         B 
    B    B    B            B BB  B             B     B     B        BB          B    BBB  B  BB    B 
B  B BB    B       B               BB           B      B        B BBB       B                        
    B          B  B      B   B     B    B   B        B    B         B       B       B B   B B        
     B B  BB B     B B B   B        B B      B       BBB      B      B      B      BB    B  BB B     
  B       B       B   B  B    B    B  B   BB       B B     B    B             BB        B     B      
 B       BBBBBBB     B        B      B        B        B       B   BBBB  B      BB    B  B           
  B  B   B    B  B        B    BBB    BB      B     B            B    BB  B  B  B   BB  B  B B       
 BB  B     B     B   B  BB               B    B   B   B  BB        B     B      B        B   B BB    
B      B    B          BB B     B B            B      B BBB    B  BBB  BB        BB     BB          B
 B  B  B          BB       B B B  B  B    B  B   B      B                       B    BB     BBB      
B                  B   B B   BB   B   B                       B             BB       B  B         B  
 B    B B BB B    B      B      B       B   B  B   B B B     B             BB  BBB   BB   B         B
 B  BB    BB                    B       B     BB            B   B   B   B  BB  B          B  B  B    
        BB     BB    B    B   B B B  B B B BB  BB        B   B     B         B B     B  B            
   BB  BB   B B           B    B         BB      B   B     BB   B              B             BB B  B 
          B            B         BB B     B B       BB   BB   B    B       B    B  B B         B     
BBB B    BB      B   B B BB  BB     BB  B    B   B B     B   B   B         B   B      B         B    
B B       B BB  B                       B B B          B       B    B  BB  B     B             B BB  
       B       B      BB      B    B       B        B        B B         B     B  B         B B     B
 B  B B        B      B               B B     B        B   B                      B     B    BB B    
 BB       B     BB       B          BB     BB  B  B         B  B        B   BBB    B  BBBB   BB B   B
      B          B      B   B         BB   B             B        B     B  B             B      B    
                  B  BB    B     B  B                     B       B B     BB B BB    B B  B       BBB
       B                 B         B     B BB    B        BB   BB B  B   BBBB  B  B     B    B       
B BBB  B B   B  BBB   B    B     B B     B B B                 BBB     B   B             B    BB  B  
A     B   B BBB   B  B  BB           BBB BBB   B   BB   B          B  B     B  B    B      B     BB B
 B B B                B    B   B    BBB                     B B            BB B BBB     B     B      
  B   B          B  B B B    B    B            B  B  B  B   B B       BB   BB  B                  B B
          B        B      B       BB      B     BBB B    B B   B       B              B         B    
  B B B    B  B            BB    B                   BB       B  B         B         BB BBB    B     
 B    B B  B           B   B        B                         B  B   B     B     B    B              
B        B    B  B   B                B B B      B         B      B         B   B       B     B    BB
  BB B B  B  BB  B    BB     BB    B    B   B  B  B  B        B B BB           BB B        B         
       B B           B   B                      BB BB B            B   B B         B         B      B
B         B        B     B                    BB         B  BB    B        B          BB  B         B
      BBB       B     B B       B    B  B BBB       B B         B B       B     B     B B    B B     
  B                    B            B       BB B      BB  B   B      B B                        B    
   B B B     BB  B      B    B B         B    BB           B B BB         B  BB  B  B  B  B B  B  BBB
   B B     B       B      B      B B       B        B B BB  B   B    B    B BB           B B         
 B  B    B     B         B         B       B             BB  B     BB B BBB        B   B      B      
     B  B B     B  B B BB  B   BB   B B                                 B         BB    B        B   
 B      B B    B         B  B       B        B B     B      B B    BB    BB            B         B   
B     B    B B B  B    BB    B        BB B             BB     B     B       B B       B      B B B   
           B    BBBBB         B  B     B    B   B    B            B    B B BB      B       B         
      B      B     B  B           BB                        B     B    B  B  B     BB     B     B BB 
 B  B  B         B B     B    B B                   BB B      B                    B       BB    B  B
        B   B BB     B           B    B  B     B         B     B  B            B          B    BB  B 
              B  B      B   B      B      B B           BB  BBB BB      B  BB                 BBBB   
     B B    BB B   B      B B  B    B  B     B   B      B     B   B     B        BB     BB         B 
   BBB                            B         B     B  B         B   B    B           B B B     B      
            B     BB B B     B   B      B  B   B  BB      B  B B  BB  B   B  B B               B    B
  B B  B   B  B   B    BB B  B           B     B    B BB       B B BB     B  B    B      B      B  BB
B    B   B      B  B     B       B         B    B    B           B    B           B B      B B     B 
     B      B     B         B     B      BB   B     B    BB   B     B  B      B     B       B     B  
 B B    B       B                   B B       B B      B   B    B    BB  B        B B   BB        BB 
                  B        B    B           B   BB   BB            B  B   B  B                       
  B    B   B   B            B  BB                   B  B    B  BB       B   B     BBBB           B   
BB   B BB B    B               B  BB       BB    BB BBB   B    B      B             BBB    B   B  B  
       B      B             BBB        B        BB        B B  B B   B B         BB B  B B B  B  B   
 B     BB   B   B  B       BB B  B        B     BBB        B  B   B        B   B        BB       B   
  B       B     BB           B       BB    B    B    BBBBB           B      B     B B  B        TB   
    B  B             B     B B  B       B   B     B           BBB        B   B B  B   B B         B  
B      B      B      B  B         B   B             B BBB  B      B       B B B BB         BBB    B B
BB         B         B B B  B      BB  B B   B B                     BB    B             B B  B B   B
  BB  B     B               B  BBB             B     BB  B      B B B B           B    BBB           
 B B  B    B B    B  B   B       B B     B                           B             B         BBB  B  
     B BB  BB         BB B  B             BB        BB       BBB      B B     B     B B  B   B       