BB  B   B     B    B     B               B             BBB  B       B B  B B       B BB        B    B
      BB        B      B    B B B         BB          B BBB  B          B      B           B B   BBB 
 B   BB   B  B B B          B BB B  BBBBBB B           B     B          B  B       B B      B  B    T
 B           B      BB   B     B        B    B B B    B          B        B       B    B      B      
   BB      BB B          B  BB       B B B  B B    B B       BB B  B  B BB   BB     B     B   B      
B B B B          B B B   B  B   B  B    B  B B              B       B       BB           BBB B    B B
     AB    B               B                B   B        B   B    B               B B  B             
   B   B  BB B BBB      B B        B  B       B B         B          B   B   BBB      B B B   BB B   
B  B  BB B    BB                B          B       B     B  B   B  B  B     BB   B      BBB         B
 B   B B  B B     B        B        BB B     B   BB          BBB        B     B  B B   B   BBB     B 
    B    BB BBB       BB               B   B    BB          B  B           BB B  B   BB  BB  B    B  
    B B          B  B    BB         B  BB    BB  B  B     B      BB B BB B  B B    B    B            
BB         B    B        B B  B B       B BBB      B   BB  BB B   B   BB  B   B  B    B            BB
  B   B B      B         B   B     BB    B       B   B          B B       BB    B       B   B B      
   BBB           B B B      B     B B                   BBB  B  B   B B B   B BB                     
    B     BB B        B       B         BBB      B      B B B B  B        BB        B     B  BBBB    
                 B        B        B  B         B    BBB  B   B                   B     B   B    BB  
      B         B        BBB     B     B   B       B    B    B      B      B B  B B       B B B B    
BB    B   B       B  BB     B  B     B       B   B B BB  B   BB B  B     BB      B     BB   B    BB  
        B BB      BB         BB           BB   B            B B    B B  B    B          B    B     B 
B  B  B B     B    B              B     B       B  B B          B B B B   BB   BB                    
BB       B    B       B B   B   B     BBB     B B            B BB      B       B B B      B       B  
             B   B       BB   B  B B  B    B             B  B     B   B B         B   B      B       
            B   B    B       BB     B     B B  B    B  B  BB  BBB B      B B    BB        B    BB    
    B    B     B   B   BB         B           B        B    BB BBB            B      B  B            
                   B                 B  B   B      B     B   B B B   B       B     BB     B          
 B     B    B   B    B B  B B     B   BB        B B   B  B     B               B          B   B BB   
B B   B    B B B     B BB           B   B BB           B     B BB       B       BBB   BBB       BB   
  B      B    B  BB  B B BB   BB      B   BB              BB        B      B     B      B     BB    B
B    B            B   BB  B   B           B         B B               B    B          B  B       B   
   B         B         B              B     B  B      B  B    B  BB         B B                      
     B B             B  B    B B   B         B      B    B             B      B BBB      B BB      B 
     B              B           B          B       B     B          B   BBB B    B    B B BB B       
          BB    B    B          B B    B     BB               B    BB B     B            B    B    B 
    BBB BB    B               B  B       B    B     B  B    B        B  B B  BB  B   BBB  B     B    
          BB BB          B   BB      B       B          B BB         B      B        B B  B          
    B         BB     B        B      BB B     B  B          B          B              B B            
   BB   B            B   B    B                B  BBB  BB        B B  B   B   B BB                B  
       B   B              B BB        B      B B       B      B             B   B B          B       
  B  B BB    B   B     B     B BB  BB                B          B            B  BB       BBBB B   B B
B            B   B       BB        B    B                BB B   B        B B   B   B B            B  
B  B B       B      B B  B        B B     B    BBB BB    BB       BBB       B      B B  B      B BBB 
B B  B        BB B B     BB     B     B B B        B B     B       B          BB B                 B 
   B B B    B               B      B        B                 B   B    B B   B B        B   B    BB  
  B         B            B             B    BB      BB B B B B       B              B   B      B  BB 
     BB        B    B B    B B                B   B  B  B   B   BBB B     B   B B    B    BB  B   B  
 B B B         B    B B  BBBBB   B      B B B   B B BB       B B   B       B   B    B B  BB B     B  
B     B      B  B   B   B B   B       BBB        B              B B              B  B     B          
        B        B    BB   B    BB BBB       B  BB B   B  B  B  BBB  B                  B  B         
       B     B     B  B    B                BB     B   B           B B   B BB  B   BB  B             
     B B  B         BB     B   B    B          BB BB  BB  BB   B         B        B  BB  B   B B   BB
           B  BB      B                  B    B      B B        B B       B B  B         B       BB  
 B B   B         B      B            B   B   B   BB  B  B       B    B    BB B   B           B   B B 
   B       BB         BB B    B B      B B  B                       B B     B                    B BB
     BBB    BBB B B   B    B    B   B      B            BB                           B BB    B B     
 B B  B   B   B        B   B         B           B  B         B     BB  BB B B      B B   BBBB       
 B     BB   BBBBB   B   B      BBBB   B    B         B            B      B   B       B BB  BB       B
 B          B      B   B    BB       B      B          B  B    B     B  B       B  BB  B         BBB 
 B        B         B  B   BBB         B      B      B        B     B   B               BB    BBB B  
   B B B             B   B              B  B  B B             B      B   B    BB     BB        B     
      B      B                BB       B      B    B   B  B     B    BBBBB           B      B       B
 B              B   B                                B   B  B    B  B             B B                
  B B  B      B       BBBB         B B B  BB B  B B BB             B     B       BB  B      B BB B   
B B     B   B       B              B B       B                    B                  B      BB       
                              B B              B BB B B            BB   B           B        B  B    
     B  BBBB B B    BB    B                 B B      BB  B    B BB            BB     B       BB     B
 BB B   BB B  B    BB        BB        BB BB   B     B    B  B             B    B BB           B B B 
    B         B        B B    B B             B   BB  B        B     BB   BB        BB  B    BB   BB 
B           B              B B B           B   B B          B  BB B B B B     B         B B    B    B
        B    B  B     B   BB      BB B BB   B      B     B      BB  BB      B        B        B      
  B     B  B          B B B    B     B    BB         B BB         B   B   B B B             B       B
           B B    B    B    B  B      B  B B            B        BB   B    B           B B        B  
  BB   B               B    B    B    B       B    B  B    BB  B     B                       B   B   
              BB     B   B       B   B    B      B       BB B B               B B  B              B  
    B    B  B           B   B B  BB            B    B    B     B  B          B       B         B     
 B          B    B   B B     BB      B BB      B  BB      B     B        B        B B   B  B B    B B
 BB      B   B         B     BB B    B    BB B       B  B       B B     BB B     B                   
BB             B     B  B                 B                     B  B  B          BB   B        B  BB 
  B      BB BBBB              B     BB      B         BB B B      B   B  B     B      B  B      BB   
         B  BBB            B        B           B BB      B  B B       B B B B  B B    B  B     B    
    B           B B  B   B     B  B    B      B  B      B         B    B BB       B   BB       B     
B   BBB            B        B B          BB    BB   B B  B                            B     BBB    B 
  B BB      B B   BB         B              B  B          B       B B     BB    BB                 B 
            B     B  BB BB        B                        B   BB             B       B    B   B     
    B  B      B        B B  B      BB B         B BB B  B   BB                         B B B   B     
B  B B        BB  B B  B      B    B   B     B    BBB B B B    B     B    B     B       BB           
      BB B          B       BB          B  B      B           B               B  BBB B          BB   
  B   B  B                  B  B B     B      B   B   B BB      B BB B   BB       B           B    BB
B   B  B B  BB B       B   B        B   B       B B     BB   B     B  B      B BB    B     B   B   B 
   BB           B      BBB BBB      B B       BB  B    B              B B          BB    B        B  
  B          B     BB B B  B B  B     B      B      B            B              B B         BBB      
 B   B        BB  B   B BB                 B       BB   BBBB  B  B  B     B     B B        B      BBB
    B B  B B B     B    B      B                BB B BB B    B         B    BB B             B B     
   B   B         B B            BBB  B        B       B     B  BBBB   B   B  B            BB      B  
B    B B  B           B                 B  BB      B  B      B     BB BB    B  B     BBB   B  B B    
   B   B                  B   B         B  B     B    B   BB          BB    B B B    B       BB    BB
    B B            B B   B B B         B           B      B  B  B  B B  BB  B     BB    B   B     BB 
            B B      B      B   B         B  B BBB            B   B                         B    BB  
   BB B     B  B    B      B        B     BBB  B       B     BB  B       B             B B           
 B  B   B            B B    B   BBB     B     B  B     B   B B     BB           B B     B       BB  B
      B  B B    B  B B                      BB  B     BB B  B B  B  B            B      B    B       