BBB     BB    B     BB             B B        B   B   B   B       B                          BB      
 B  B B                B B   BB  B        BB B     B    B BB    B     B   BB B  BBBB        BB B    B
      B B  B    B B   B             B     B   B                           BB         B       B  B B  
       B  BB   B               B     B              B  BB                BB     B      BBB  B   B    
   B B     B B B B      B B         B     B B   B  BBB    B         BB    B    B                 B   
  B   B B   B B B B        B     B   B  B B              B      B B  B  BB    B  B     BB            
 B BB B        B BBB         BBBB  B   B B       BB   B     B       BBB BB    B         B B          
   BB               BBB     B         B    B    B      B         B   BBB  B   B             B   B B  
                B B   B     B  B        B     B    B  B    BBB       BB  B B            B     B      
 B                B        B          B       B     B     BB      B        B     B         B B   B   
      B         B               B  BB  B        B              B B  B B   B     B   B      B       B 
    B B   B B    B    B  B   BB  B             BBB      B  BB   B  BBBB  B     BB   BB     B      B  
B  BB B   B             B B  B     BB   B    B  B  B         BBB     BB     B  BB   B   B B          
     B B  B    B B  B           BBB B  B      BB BB B                B     B   B         B    B B B  
  BBB    B    B        B    B B BB  BB     B       B B        B  BB          BB      B     B B       
 B   BBB  B    B   B       B       BB         B            BB   B         BB B   BBB                B
B    B  B    B   B       B  B B B   BB         B   B B      B          B B      BBB   BBB            
   B      BBB   BB B B  B       BB     BBB      B BB   BBB    B    B    BB           B       B BB    
B  B B     B    B       B          B    B  B    BB  BB  B BBB                           B  B         
       B  B        B         BB     BB    B BB BB   B  B  B   BB               B   BB            B   
BB      B B B B   B      B     B  B    B B  B B  B  BB         B     B  B   B    B                   
              B B      BB         B  B                  B     B B  B B    B      B B     BBBB       B
  BB                           B    B     B BB B    B      BB  B            B              B  B      
B         BB BB  B         B     B       B  B B   B B        B   B     B   B     BB   BB BBB    B B  
B     B    B       B  BB         B B       B    B   B    B  B B B     B    B B B    B           B    
          B        B  B      B      B        B                B         B  B     B                   
    BB B                B         B B   B  B       B    BB             B BB B             B  B B    B
     B B B B    B   B  B      B B  B B B     B    B    B   BB       B BB       B B B    B    B       
   B      B B                   B B   B  B          B     BB      B   B           BBBBB B          B 
B    B   B BB     B      B B    B         B     B     B     B  B B    B   BBB BB     B BB          BB
     B        B      B     B B    B B    B  B     B   B   BB    B B    B        B    B               
 B B                BB         B  B    B     B  B  B          B BB  B   B  BB    B     BB     BB     
 B B         BB B B BB          B  B  B              B     B      B       B    B B  B B    B       B 
            B B    B  BB         B      B   B         B  B   B           B                           
       B   B     B    B  B     B  B   B        B        B      B   B B        B     B B BB  B    B B 
B  B              B   B  BB  B  B   BB      B BBBB       B            B           B     BB    B      
              B       BB     B     BBB  BB B     BB              B     B                          B  
 B   B    B                B                B   BB       B     B B  B    B    BB  B B                
              B B  B     B B  B  B          B   B     B    B B    B       BB   BBB  B    B    B   B  
              B   BB    B    B                         BB           B                      B   B B   
   B      B      B   B   BB     B    B  B    BB                  B         BB   B B     B           B
       B    B BB      BB   BBB B  BB   BB  B B      B  B      B                 B               B   B
      B     B B    B        BB                        B   B         BB    BB BB  BB   B  B   BB      
      BB   B       B   B    B       B  B   BB       B B   B         B B  B   B B     B    B  B    B  
 B  B              B  B   B       BB    B      B B  B           B  B  B    B     B            B B B  
 B  BB       B                 BB    B  B    B  B              B        B           B   B  B         
                  B       B        B   B    BB   B B  B     BB B    B           B   B          B     
  BB B     B      B B B B        B   B   BB  B     B          B    B         B   BB   BBB      B    B
  B               B    B   B B  B       B  B     B B           B    B BB  BB  BBB  B      B B      BB
          BB  BBB              B                BB     B         B   B    B      B  B       BBB      
 B BB         B  B          B        B B     B     B  B B  B             B            B         B    
                 B       B    BB   BB         B        BBB   B     B    BB  B  B         B  B     B  
   B  B B B        B          BB                  B B  BB   B B     B          B    B       B B  B B 
 B          BB         B   B              B       B            B    B     B  B  B      B  B    B     
    BB  B          B B     BB  BB      B   B     BBB B   B                B       B B   B   BB B    B
         B   B   B  B        BB               B    B   B        B      B                 BB  B   BB  
         B BB B       B    BB   B  B  B    B   B  B      B    B B             B     B B   B    B B   
 BBB   B  B  B     B B    BB   B BB   B     BB         B  B   B     B B  BB  B    B BB  B B       B  
         B       BB            BB      B B     BB B        B       BB   B  B     BB      BBB  B B   B
      B      B  BB   B                B B  B B     B      B                  B    B B      BB   BB B 
  B     BBB  B           B       BBBB   B         B  B              B    B  B      B  B   B    B     
  B      B  B        BBB  B     BB   B    BB   B        B BB          BBB     B   B             B B  
 B         B  B   B   B   B    B        B    BB BB  B        B      B B   B       BB   B B B         
 B    B      BB        B B         B   B        BB  B B  B  BB    B     BB B     B         B         
  B  B                    B    B B  B     B             B        B  B   B  B B  B  B  B  B  B      B 
B   B               B   B        BB           B                BB   B   B B   B    B  B BB           
B  B    B B   B    B B B     B      B                       B         B     BB       B   B           
   B B     B    B              B      B  B             B BBB   B B        B    B                  B B
B    B      B   B    B       BBB                   B        BB    BBB  B B  B B          B    B      
B B BBB  B B B  BB B B       B B B     B B   B B   B   B     B        B     B         BBB   BB      B
 BB  B  B         B      B    BB  B B          BB                B  B                    B           
             BB B B   B          B   B B         B  B  B B        B     BB    B  B            B      
BBB           B         B           B   B B   B B  BB    B       B B                BBB  BB          
             B                     B        B                  B  B          B B            B      B 
BB    BB   B    B BB BB   B  B B  B  B   B           B     B            B  BB  BB   B    B          B
  B    B B  B           B  B B     B   B      B B  B    B        BB   BB     BB   B     B   BB       
BB    B        B     B  BB   B  B  B B B  BB       B                 B  B B     B B   BB    B B      
     B        BB      B     B B B B     B    B    BB  B B          B  B          B B  B             B
  B   B       B  B    B BB     B  B      B       B  B BB  B       B       B B            BB    BB B  
B  B      B        B  BB   B   B BB              B BB BB  BB   B B   BB            B      B B B  BBB 
         B B    B         B  B        B  BB   B     B  BBB           BB       BB          B          
BB         B                  B BBB          B    B       B B  B  BBB   B        BB  B    B  B B     
       B B     B  B            B  BBB           B          B    B               BBB         BBBB     
B                B   B   B  B  B                     B     B    BB     BBB B        B B    BB  B  B B
   B      B                      B BBB                BB  BB  B   BB   B             BB     B BB     
  BA B     B B              B   B  BB B  B              B   B             BB BB               BB     
B            B       B BBB            B B     B   B              B                B         BB   BB  
     B B   B     B   B  B B   B        B       BB B   B   B B      BBB  B  B B   B    B   B   B BBB  
B  B     BB     B    B     B  B B      B B    B      B    B          BB         B B     B            
B     B      B  BB  B  B     B    BB          B      BB   B  B   B                B   BB        B    
   BBB    B B  B    B             B               BB                    B              B     BB B    
 B B B B B    BB     B   BBBB B   BBBBB        B B  B   B    BB  B   BB   B  B        BBB B  BBB     
B  B             B       B   B    B       B  B          B            B  B    B  B B  B  B    BB B    
   B   B B        B B       B   B B    B         B BB          B            B    BB   B           T B
  B BB             B     B          B           B      B          B    BBB B   B     B   B   B      B
     B      B  B      B   B                 B     B  B BB  BB    B   BB   B BB   B  B            BB  
   B       B                    B  B B   B   B        B  B B   B  BBB  B  BBB     B      B   B       
 B     B         B      BB   B     B   B B  B  B    B      BB B B    B       B B    B B     B B B B  
       B    B   B  B                      B    B B         B            B    B B B  BB    B BB  B   B
   B    BB    B BB               B B         B  B B  BB  B  BBB  B              BB  B    B           
 B    BBB            B         B          BB   B      B       B          BB      B      B       B    