    B        B B         B          BB B   B  B  B  B    BB  B            B        B B     B         
B  B  B   B   BB   B B B B    B          BB   B B BB    B            B                B    BB        
       B     B           BBBBB           B      BBBBB            BB  B    B  B      B   B      BB    
  B  B  B      B             BB            B    B  B         B    B       B   BBBB B          BBT    
   B B              B    B        B   B             B   B  B       B B         B BB   B  B      BB   
 B  B     B        B  B     BB    B          B   B  B B  B              B     BB       B  B    B  B  
       B    B B      B B   B BBB  B   BB           BB    B  B     BBB B B BB         B               
     B   BB B                  B           B B   B    BB            BB     B      B   BBB     B  B  B
    B          B               B   BB     B  B   B  B B B  B         B B   B       BB     BB   B BB B
     B    BB BB B    B      B      BBB  B         B         B   BB      B B B B      BB              
          B    B BB  B                                   B     B    BB         BB B  B      BB   BB  
B  A                       B   B B       B   BBBB      BBB        B  BBB         B    B   BB B      B
            B B          B     B      B   B    BB  B      B     B     B  BB BB  BB        B  B B     
B   BBB B   B BB     B  B   B      B                       B           BB   B    B     B            B
      B       B         B     B       B        B               BB B      B  BBBB        B B BB     B 
  B BB BBB       B   BB    BB     BB     B  BB     B                  BB      B   BBB      B       B 
        B  BBB B          B       B   B B    B       B B    BB  B                   B         B  B   
 B   BBB B          B    B BBBB     B  B    BBB  B   B       BBB  B       BB        B B    B     B   
 B      B B     B   B BB    B                 B         B           BB    B  BB     B B         B    
    B   B   B B   B   B  B B         BB  B B         B         BB B   B B         B  B B  B B        
           B     B     B     BB       B         BB   B      B B B B BB              B B  B  B   BB B 
  B B                       B     B B BB    BB   B      B    B                B  B  B   B B          
        B    B                    B            BBB BB   B    B      B   B B   B         B        B B 
              B          B   B   B  B B B B   B BBB        B B   BBB B BBBBB          BBBB  B BB B B 
B      B  B  B     B B B    B  B B  B  B   B B B      B         BB          B   B  B B     BB  B  B  
B  B B          B B    B B     B B        BBB B     BB  B  BB B   BB  B BBBBB       B         B    B 
B   B   B  B         BBB B  B     B     BB B B             B            BB B     B BB   B  BBB   B   
B           BB        B  BB       B               B     B B B    B   B              B  B             
 B             B  BB   B      B BB     B    BBBB   B       B         B         B BBBB B      B B   B 
 BBBB                 B           B   B    B B  B  B  B      B           B B     B                   
   B BB     B    B       B    B               B  B  B    B       B      B              BBB  B BB     
            B B   BB   BBB   B   B      B              B  B          B                 B B       B B 
      B    B  BB       B    B          BB     B   B  B B  B    BB   B B B                    BB    B 
 B    B     BB B         B B    BB   B  B      B              BBB   BBBB           B B   BB  B       
      B B          B                   B                B BB      B B    BB    B    BBB    B   B   B 
  B B       B     B   B B    B         B      BB  B   B         B    B     B BB         B BB  BB     
        B    B                   B     B   B         B       B       B BB            B  BB     BB    
    B      BB   B      B   B       B B B      B      B B    B     BB   B    B B B B   BB       BB    
  B   B    B         B   B  B   BB        BB         B   B  B   B          B         B B          BBB
 B   B                     B    B  B                  B          BB B   B BB      B  B           B B 
              B   B     B   BB  B    B BB           B       B B      B       BB B B  B B BB  B   BBB 
B B            B  BB   BB   B       B     B     B B                   B    BB         BBB BB       BB
B                B                        B B  BB  B B B                B  B      B B  B     B BB   B
       B                B  B       B              B    B    B   B   B    B            B      B B   B 
       B  B          BB          B      B B B     BB       B BB  B  B   B B  B  B     B    BB     B  
       BBB          B     B BBB   B  B BB       B B                       B  B      B  B B  B  B     
               BB                     B B         B  B   B        B B  B  B  B    B     B  B   B  B B
    BB     BBB B  B      B       B   B   B         BB B          BB      B BBB          B B  B       
                      B         B     B   B      B B   B B B B B B      B            B B   BB        
   B     B B    B         B    BB   B  B        B BB B B B     B    B  B        B           B   B    
                           B            B         B     BB BB B  B    B B      B B   B  B  BB B B  B 
    B     B B   B       BBB B     BB B B  B  B B     BB    BB     B B    B       B  B B     BBB   B  
        BBB             B   B  B        B   BB  B BB       B      B  B    B    B  B    BB B        B 
  B B  B     B   BB     B B       B     B  B     B    B B B   B        B     B  BB   BB      B  B BB 
B    B     B  B B       B   B       B        BB  B   B                B     B        B   B      BB   
       BBB      BBB            B B     BB    B       B    B B               B        B  B B      BB  
 BB  B     BB   B   B  B B B          BB     B      B         B  B      B  BB         B  B           
B    B                 B        B     B        B         B        BBB   B  BB      BB    B       B B 
       B B  B          BB     B   B  B      BB B   BB B  B  B         B BBBBB  B B     B    B BB BB  
  BB    BB      BB B  B          B  BB  B  B BBB   B BB      B  BB BB B BB   B        B   BB       B 
    BB   B   B   B  BB  B  B   B   B      B      B  B   B  B  BB B      BB      B   B  BB   B   BBB  
BB         B B                         BBBBB   B    B   B   BBB   B B           B       BBB  B   B   
 B         B  B   B      B    B B                 B      B     B   B B     B  B BB          B      B 
   BB  BBB B  B   B    B                B    B                B   BB  B        B              B      
B B      BBB B  B             B  B          B   B    B                     B   B     B     B      B  
 B BB   B  B             BB  B B     B  B        B  B B     BB BB  B B     B B            B  B  B  B 
 B      B     B   B BB     B B     B  B      B B        B       B   B    B B BB         B  BBB    B  
BB     B  B  B     B      B B B  B     B           B B                B     B B  B      B B  BB B B  
  BB  BB B  BB B   B B            B          BB   B  B         B                  BB            B    
             B       B       B  B  B     B B          B B           BBB  B   BB                 BB B 
BB BB        B BB B         BBB B   B B       B B      B     B     B                B     B  B B     
     B      B  BBB    B       B     B      BBB B  B BB     B       BB  B B        B                  
  B      B     B B   B  B            B  B            B        BB  B          B     B   B     B   B B 
B          B  B B   B   B         B   B B      B  B B  B          BB           B  B     B        B   
B     B  B   B    BB B        B        BB      B  BB         B    BB           BBB BB    B          B
B B       BB              B     B        B             B BB               B       B B     B   B  B   
     B     BB     B B BB   B    B  B B         B B BB   B                B   BB   B B           B    
    B    BB      BB  B B   B    B  B       B  B              B    B    B           B      B   B  BB  
     B B    B    B B       B     BB                B     BB  B  BB  BB             B           B B B 
        B   B   B         B B          BB     B   B  B B   B        B   B   B  B     B         B  BB 
  B B          B      B B            B      BB     BB B        B  B      B    B            B      B  
           B   B         B       B    B B B       B   BBB     B   B   B     B BBB   B  BBB  B  B     
    B  B  B B     BB    B B B  B   B     B   B  BBBB   B                    BB     B B     B         
      B   BB      B B                B   B    B  BBB      B   BB  B B  B BB  B B B B    B    B B  BB 
B  B                B     BB        B      B  B  BB BBB              B    B B             B B  B B   
 BB B    B BB       BB        B  B B     B          B    B           B        B B   B  B             
B BB           B     B  B    B     B B        B           BB       B  B     B       B BB    BB   B   
    B  BB B    B        B   B       B   B   B      BB B  B     B     B           B     B B   B   B B 
            B B   B  B       B          B    B   B  B B   B        B     BB        B B         B     
BB B  B  BB    B           BB        B  B             B    B         B  B  B     B  B  B     B   B  B
     B   BB      B BB  B       B BBB B               B  B      B        B   BB   B  B     B     BB   
   BB    B     B    BBBBB      B B  B        B        B B   B   BBBBB B            B   B BBB   B     
 B           B    B   B                B B    B B    B BB     BB   B      B B    B   B   B B  B B  B 
       B BB    B     B  B        B    B    B       B B  B          B   BBB           B    B    BBB   
              B  B    BB  B   B B  B  B            B B    B        B     B B   B       BBB B      B B
  B  B       BB B     BB     BB  BB       B    BB  BB        B    BB   B    B         B     B  B   B 
        B B       B B B B   BB         B   BB               B  BB B       BBB       BBB      B    BB 
B BB       BBB    B   BBB B  B B      BB       B                        B  B     B  B    B   B       
   B  B    B          B   BBB  B       B    B  B  BB  B   BB           B B      BB B B B  B  B       
BB    B B    B  B          B    B    B B           B BB         B    B  B   B   B     B             B
B  B    BB B         B      B         B    B B     B        B B  B B  B    BB   B        BB        B 