         B  B   B B  BB    B  B B  BB   BB        BBB  B   BB BB      B  B         B  B    B B       
           B    B B B   B B B    B B B B  BB   B       B              B     B    B   B   B    B BBB B
B    B B BB           BB  B                   B        BBB              B   B  B                     
B      B      BB     BBB  BBB   BB       B     B       BB    B  B    B            B B         B  B B 
       B  BBBB                        BB    B     B B   BB   BB     B  BB B      B    B      BB   B  
    B       B B B        B B    BB B  B B          B          B         B                   B B   B  
      B      BB          B   B   B     B    BB     B     B       B         BB          B   B         
   B  B B B       B  B B  B      B       B    B      BB                 B     BB   BBB  B            
 BB    BB       BB B B           B    BB B     B   B          B  B B          B   B    BB        B  B
   B  B   B   BBBB  BB    B BB      BB                B B    B B   B    B  BB  B B B   B B     B     
     B B       B  B   B B      B   B    B BBB  B B        B             B        B  B       B   B    
    BB   B              B             B     B   B   B    B    B B       B BBB         B              
B B       B   B B  B      B  BB   B    BB      B   B  B  B           B    B B  B  B        B B    BB 
 B B     B BBB BB       B B  B  B                B   B       B   B  B         B B  B  B       B     B
                     B    B  B    B B       B   B    B    B  B      BBB            B  B             B
                 B        B      BB                  BB BB       B B B B    BB B B   B     B B   BB  
 BBBB  B B    B    B    B                   BBB     BB             B  B       B  BB  B        B B  B 
     BB       B  B     B                B    B  B B      B      B   B B   B   B B     BB  B   B     B
BB   B               B       B  BB      B B        B        B B    BB      B     B B BB       BB    B
   B BB     BB    B   B    B    B B                   B B    B        BBBB   B B    B      B B B     
  B B           BB      B   B                B      B B      B      BB   B          B     B    B     
        BB  BB    B B          B B     B  BBB        B    B          B        B   B     B B     B B  
      B      BBBB BB        B  B        B                     B      B      BB   B       B     B     
    B    B B   B   BB    BB             BB  B        B    BB B B  B            BBB  BB         BB B  
   B  B B B     B    B   B  B   B B            B   BB   B  B B                  B     B       BBB B B
  B    BB         B B           B     B  B         B B            B BB         B BB         B  B     
  B                     B          B  B   BBBB BB        B     B   B  B      B      B BB B  B        
 B  B B  BB   B      B   B      B   B        B  B       BB       B        B B          B  B      BBBB
 B   BB    BBB    BB BB B      B              B B   B B B  B          B     B      B   B  B          
B    B      BB B B  B        BB           BB           B             BB   B  B   B   B  B         B B
B                B   B      B    BB  B   B   B B B            B    B       B   BBB         B     BB  
   B B        BB                                              B         BB                   B       
   B    B B      BB       B          B  BB            B        B     B  B BB B  B     BB  BB        B
      B    B         B                      B BB    B    BB    B B  B      B B  B   B       BB    B  
 B      BB          B          B    B       B        B   BB B           B     B                  B   
  B                B         BB      B  B       BB BBB   B    BB       B     B B        B     BB     
      B   BB  BB          B     B      B B B BB        B B     B       B B B    BB        BB     B B 
B    B   B    B  B    B BBB      B   B       BBBB    B BB       B  B     B     B         B          B
 BB  B B   B          B  B     B         B    B  B  B  B  B    BB       BB    B         B B        B 
B         B   BB         B  B   B    B  B  B  B    BB      B       BB          B    B          BBB BB
 B       B B      B       B      B  B  BBB    BB    BB         B  B            B    B  B       B     
B    B    B  B       BB      B                 BB         B         B     BBB              B   B B   
      B B      BB     B       B            B   BB BB        B B    BBB    B      B   B B   BBB      B
B                 B B       BB  B        BBB    B B        B     B   BBB BBB   B      BB        B    
B        B    B             BBB B               B     B      B            B          B        B BB   
       B  B      B  B  B  B    B   BBB   B          BB       B       B   B     B   B BB   B      B B 
 B          B                        B   B    B  B    B      B        B      B        B              
 B        B   B B   B     B  BB    B        BB      B    B   B        B B                  BBB       
      B      B  B   B      B    B   B  B    B B        B    B B  BB B   B         B     B       B   B
     B                  B   B B B       BB        BB  B  B    B   B  B          B     B        B B B 
  B B         B          BB      B      B B  B      B B   BB B     B B    B                B        B
               BB             B   B           B BB B      B        B     B      B           B   B  B 
      B      BB    BBB B       B    B  B B                B     B B   B  BB              B    BB    B
B    B       B BB  B      B           B  B     BB   B           BB           B     BB    B    BB   B 
  B   B  B        B    BBB  B    B      B B B   B  B     B  B      B B  BB  BBB   BB B       B   B B 
   B      B              B BB B     B  BB BB      BB      B B        B                               
    BB          B BBB  B     B  B       BBB B  B  B     BB BB            B BB B B    B    B      B  B
BB   B        B     B  B  B    B    B          B B          B    BB B  B   B       B  B              
     BB    B        B       B        BBB    B                B   B BB        BB B                BB  
 B     B      B           B      B     B       B B        B              BB B    B          B        
  B       B      B  B       B B  B      B     B    B  B B       BB             B                   TB
B     B         BB      B      B    B B  B           B   B B         BB         BB BB        B     B 
   B B           B   B    B  B      B        B    B          B        B           B         B B    BB
  B       BB          B B            B      BB          B B    B BB           B        BB  BB   BBB  
 B B BBB  BBBB      B         B B        B B              B         B          B            B      B 
  B A  B            B   B   BBB        B   B            B         B B  B           B        B       B
    B      BB  B   B  B        B  B       B          B  B B  B B  BB B             B       BB        
    BBB  BBB      B    B B       B   BBB  B              B B   B   B B B     B       B    B  BB BB   
         B   B         B   B  B B            BBB B    B        BB         B  B   B    B   B  B  BB   
 B   B           BBBB B B        B B     B B    BB    B  BB   BB  B    BBB B  B   B B   B B  BBB B   
B       B       B       B BB    B   B       BB       B  BB       B    BB      B B BB       B B  B    
        BB   BB       B     B            BB          B B    B       B  BB  BB    BB  B     B  BB     
          B B           B   B   B     B B        B                       B    B   B        B     B   
B       B  BB      BBB  B   BB    B      B             B    B   B        B     BB  BB    BB B B     B
   B      B    B     B B  BB  BB       B B     B                   B    B    B  B           B       B
   B   B       B    BB    B     B B     B      B B   B       B   B  B B BB    B         B   B   B    
        B      BB B   B               B      BB BBB        B B  B        B       B B B BB         B  
B        B      B   B       BB  B    B         BB                BB B  BB B    B                 B BB
BBBB  B     B   B B       B B  BB B    BB   B B                 BB   BBB             BB           B B
B   B            B     BB    B   B        BB B B B B BBB             B B             B    BB BBB  B B
       B  B  BBB    B      BB      B     B                 B        B     BB   B     B         B     
 B     B  B B  B  B            BB            BB          B    B         BBBB   B   B         B  B   B
     B            B      B  B B B    B    B   BBB B              B   B            B           B     B
 BB     B                B  B  B  B   B     B B    B  B           B   B   B       BBB         B      
   B B     B       B           B   B   B B  B     BB  B   B BBB   B B     B           BBB     B B B  
         B   B            B    B   B B                  B        B    B      B       B  B   BBB   B  
  B    B BB            B         B BB             B  B  B                 BBBB   B       B    BB   B 
    B  B    B B  BB  B               B               B        BBB  B         B  B  B   B   B BB B    
B          B    B           BB  B   B B  B   B     B B         B     B      B    B     BB BB         
B      B  BB  B   B  B B          BB BBB   B B           B   B  B  B B BB        B          B  B     
    B         B       BB B B   B     B BB B B BB   BB   B B B B        B          B     B    BB  BB B
       B      B  BBBB  B   B      B  BB     B    B B B    B    B       B     B  B      B     B   B   
    B   B         B B          B   BB              B   B B                B      B  B       BB  B B B
   B B   B          B      B  B         B  B        B       B            B   B        B      B B    B
B      B  B B B        BB                B     B     B  B  B     BB             B        B B BB      
 B    B   B        B        BB B     B  BB   B   B  B    B           B  B        B     B   B BB   BB 
        B B B   B  B     BB  BBBB B    B        B BB      B B      BBB         B  B B  B  B        B 
BB   B                    B BB    B                    BB   B  BB    B B  BB     B B B B      BB B B 
   BB     BBBB  B BBB                        B  B    B  BB      B B  BB    B        BB  B  B        B
             B BB          B    B   B       BB B  B B        B       BB B     BB             BB      
B  B B           B    B       BBB B   B   B  BB  B                        B B B BB         B      B  