      B  BB     B  B  B       BBBB   B           BB BB      B    B           B         B             
       B        B    B    B   B      B        B  B    B BB          B B  B        B     BB        B B
     B  B    B     B B  B     B B  B   B BB        B  B     B    B   B      BB     B       B       B 
              B  B       B     BB  B            B  B  B     B  B  B    B B        B     BBB          
         B B  B            B  B    B  B       B   B  B    BB   B         B  B  BB B B                
     B  B  B    B B    B   B   B  B  B             B            B     B  B                  BB       
  BB    B B   B      BB      B              BB   B  B                    BB          B        BB     
          B    B           B   B  B   B                  B         B       BBB   B               B   
  B B   B  B  B        B                B             BB  B    B   B   B   B       B BB B  B  B  BB  
      B  B  BB    B B  B B      BB          B B   BB         B B        B B   B                    TB
BB                B  B B   B   B B           B B B       B  B B     B   B        B          B        
       B    B         B B B  B B       B    B            B     B     B        B   B    BB  B B B B   
  B     BB  BB         B  B    B  B            B  B BB B   B   B         B      BB       BB       B  
B        B  B   B B  B              B              B B B             BB  B     B   B    B  BBB   B   
  B     B    B B           B           B        BB   BB   BB B      B  B B                    B    BB
   B          B     B       B      BB    BBB B    B     B B     BB         B              B    B     
BB B   B    B      B    B         B B                  B    B B B    B   B        B B                
 B    BB    B  BBB   B                 B    B   B   BB B B    B  BB  B B    B       B             B  
    B B   B         BB    BB   BB       BB  BB B         B   B  B    B B       B               B     
      B          B   BB                        B   B             B     B         B   BB              
      B     B         BB  BB     B   B B        B           BB         B B    B   BBB     BB       B 
    B      B     B    BB   B    BB    B                    BBB   B      B   B   B              B     
  B B            B  B B  B        B B   B   B    B   B   B   B  B    B B     B       B  B B B   B    
  B          B                 B    BB    B BB   B              BB        B   BB     B            B  
B       BB B  B    B  B     B     BB    B  B    B B                    B        BB       B     B     
B      B                B      B    B B BB BB                      B      B   B  B        B      B   
     BB     B     B  B B  BBB B  B      B           B B   B    BB     B  B   BB B B B       B B B B  
                 B   B B  B              B B   B  BB    B        B        B        B      BB  B B  B 
 B  B  B   B  B B       B B  B      B       BB  B B   B    BB    BB       B       B           BB    B
 B       B BB  BB   B     B    B       B    BB         B      B B   B   B      B   B         B       
   B B B    BB   BB     B B   B      B    B B    BB  B         B     BB   B    B BB      B           
 B     B       B  B    B B  BB B    B      BBB         B    B              B               B B       
    B    B    B     B B  B B B      B B       B  B     B    B    B B        B B BB B     B B  B      
      BB B  B          B                     BB         B    BB            B      B  B  B  B BBB     
   B                    B  BB      B   B    B  BB    B BB  B              BB     B  B            B   
 B    B   B B B             B      B      BB            BB        B  B       B B   B        B      B 
 BBBB        B  BB                            B           B  B  BB     B     BB B    B     B     B   
B       B B BB     B BBB          B  B     BB  B        B B        BB    B      BB B  B      B       
B B      B B                 BB B                BB BBB  BB B          B           BB B     BB       
  B    B B                 B    B      BB  B    B   B B           BB  BB  B     BB         B B BBB B 
  B   B BB       B      B        B        B  BB    BB BB    B   B       B         B            BBB   
        B      BB B      B      B    BB    BB         BB B       B              B     B           B B
BB         BB  B     B      BB       BB B                  B          B                B             
B      B        BB B   BB  B  B B  B          B        B    B BBBB         B    B B B   B B      B   
    B   B B  B    B   B      B     B          B B                 B B                               B
 B     B B                          B      B       B        B      B     B            B      B  B  B 
        B  B     B   B                                 BB    BB    B   B   B      BB B          B   B
                B   B                      BB         BB B      B   B        B B  B           B     B
     B     B               B       B B B   B B    B          B        BBB    B      B BB B     B     
 B   B  B           B         B B    B   B  B BB  B   B  BB         B    B         B        B    B  B
 B             B B        B  B      B   B B   B   B       BB  B   B   B BB       B       B      B    
        BB  BB     B          B B   B   B          B   B  B    B  B       B       B   B B B        BB
 B BB    B     B               BB  B        B   B    BB   B B   B B   B                         B    
     BB   BB  B        B            BB  B        B                 B   B  B    B    B     B BB B     
  B B     B   B      B B B B   BB B     B B   B  B B B  B         B   B  B       B      B    B BB   B
   B          B  B B B      B  B        BBB   B B    B   BB        B  BB   B  B B          BB  BBB  B
       B           B  B B            B         B BB  B BB    B      B        BB  B      B         B  
         B      BB           B        B   B   BB        B B        BB BBB    B B   B  B    BB   B    
             BB BB       B   B BB      B   B    BB BB        B     B      B               B B     B  
    B  B          B  B        B        B B  B BB BB  B B       B B            B   BB  BBB     B B B B
   B B  B    B              B      B      B      B                  B     B    B B    B  B     BB    
 B B B B      B             B     B       B B B B             B       B B  B        B   B BB  B B  B 
            B              B B  BBB B        B    BB BBB   B B     BB            BB  B    B   BB B   
  B       B B        BB       B    B  BB   BB    BB                 B B   BB B     B   BB B       B  
B  B   B      BB   B BB  B B BB  B               B    B            B     B        B  BB B   B        
 B B    B     B     B  B       B               B         B           BB B  B                         
       B               B B  B  B        B      B  B B        B    BB    B  B       B    B       BBB  
            B    B  B     B  B   B   BBB   B             B         B           B B   B          B  B 
B                             B   BB B  B       B BBB      B B        B     BB                       
           B  B         B        B          B                   B    B B                BB   B  B    
  B B BB  B  B           B  B      B  B             B    BB  B   B  B B  B  B    BBB  B  B     B  BBB
B BB    B    BB BB   B   B BB  B  B          B  B BB     BB        B     B  BBBB        B  B      B  
   B               BB    B              B            BB B    BB  B         B    B B    BB        B   
      B          B      BB     B  B B BB B      B  B          B B     B    B B  BB BB B  B  B   B    
B       BBB       B  BB     B        B B    B       B  B BB  BB      B                  B B     B  BB
B  BB         BB  B  B    B  B       B   BB                  B  B  B B         B     B        B      
   BB     B   B BBB       B B  B         B B     BB B B  B BB  BBB B  B B      B        B  B      B  
B  B      B   BB BB  BB      B   B  B           BBBB   B B B   BB    B           BB   B          B   
     BBB BB     B          B B       B  B    BBB  BB     B B  BB B     B      B       B              
       B B    BB B     B B  B B  B       B      B     BB   B        BB           B   BB   B      B   
                B   B  B   BB      B B BBBB        B      B BB      B  BB  B                 BB   B  
        B B   BB    B     B BB    B     BB B     B      B   B B B   B     B             B B B      B 
B  BB     B         B     BB  B     B   B    B     B                 BB BB BB             BB        B
            B  BB  B  B          B   B     B        B B   B         B  B       B B   B             BB
B   B B   B  B  B  BB    BB  B    B   BBB  BBBB          B     B  B  B       B    B    BB     B   B B
       B     BB      B BB         B B B   BBB B    B     BB            B  B  BB      B    BB BB B    
                 B      B   B           BB           B B      B   BB   B B         B            BB   
      B   B B   B    B          B B BBBB      B    B         BB             B   B B    B  B  B       
       B    B     B    B  B            B B         B        B     BB          B B    BBB  B   BB     
 B     B BB    B          BB  BB B     B       B B                   B B  BB       BB  BB  BB        
 B   B    B      B  B B B B  B    B    BB    B      B     B  BB     B    B  BB    B   B              
  BB    B     B          B             BB             B   B    B                 B     B B           
B     B     B B   B       B BB   B    B BB  B  B   B             B    B   B       B     BB  B  BB B  
  B  B   B  B        B B          B           B   B         B    B                 BB B   B BB       
B      B     B       BB         B  BB       B    BB          BBB   B B       B  B    B  B B    B B B 
       B     B      B          B  BB         B       B B      B B     B                       B  B  B
 BB  B           BB  B B   B         B  B        B   B B    B         B            B  BB B      B B B
  B           BB B    B     B B    B       B  B       B         B B    B B         B B            B  
 B  BB B     B  B            B     BB       B      B  BBBB  BB  B B BB        B  BB B  BB      B  B  
B B   BB      B    B  B  B B B   B          B    B B  B         B B B           BBB                  
  BA                   B BB      B B B    B   B   B B     B B                 BB B BB B    B B  B    