 BB       B  BB B           B B      B   B      B  BBB  B B  B B  B B         B                   B  
   B BBBB     B B   B     B        B BB   B     BB  B    BB  B B  BB    B B        B           B     
     B       B       B   BB    B    B B B B    BBBB   B      B    B B B   B  B B   B  B   B  BB B   B
     B                  B   B    BB    B  B  B       B     B    BBB        B B   B   B           B   
B          B  BB      B      B B           B   B  BB  B  B B  B  B B  B   BB  B      B  B    B    BBB
  B     BB           B    B    B        B      B       B      B B     B B     B         BB  B   BB   
     BB   B B    BB    BBBB        B   BB     B B   B    B         B         B        BBB  BB B      
  B BB B   B           B            B B    B      B            B B BB    B B B           B  B     B  
        BB  B     B     B   B    B        B    BB BBB     B  B   B   B               BB           B B
 BB B      B      B  B       B    B     B  BBB         BB B          B   B     B  B      B  B    BB B
                 B    B   B               B    B            B  B  B    B    B  B B   BBB B   B      B
     B    BB  BB  B  B       B   B B       B      BB    B    B   B   B      B B    B  BB BB  B B    B
 B      BB  B    B     BB    B         B    B    B   BB    B  B   B B  B      B    BB           BB   
         B  B   B       BB                B  B  BB       B         B BB     B     B B            BB  
B B  B                     B  BB  B   B  BB  BB                  BB     B    BB    B    B            
       B      B         B    B   B            BB     BB     B        B    B  B     B              B  
  B  B                BB B    B    B  B      B                  B   B       B     B                  
 B  BB B     B    B B BB       B      B   B         B  B  B    B B         B           B         B BB
       B             B    B         BB B    B         B       B       B          B BB    BB    B  B  
B     BB     B                BB     B      B                    B     B           B B   B        B  
B    BBBB          B        B BB BB    B               B   B B        B B        B   B     B   B  B  
     B    B         B B B            B    B      B     BB         BB  B  B                     B  B  
   B   BB          B      BB          B       B            BB    B                  B B  B           
     B B B    B  B                 B     B        B        B    BB BB     B       B B           BB B 
       B     B  BB B B         B B B                 BBB B    B   B     B  B           BBB      B    
     B B    BB        BB       BB BB    B         B BB     B    B B B B             B  B     B    B  
B  B  B B      B  B B    B    B    B         B   B B  B     B          B       B     B  B    B     B 
  B B     BB B  B    B          B    B  B  B   B  B       BB       B   B B   BB  B B          B  B   
    B   B BB  BB       B        B   B           B                      B         B B          B     B
   B      B  B            B  BBB              B    BB   B  B B B BB     B   BB    B       B   B B    
      B  B    B   BB B       BB    B   B     B  B    BBBB      BB  B        B BBB  B     BB    BB    
   B      B         B     B B   B   B B B              BB        B      B     B               B   B B
 B      B         B  B B  B        B     B B      B     B B BB  B    B B    B    BB        B         
  B B   BB      B                   B    B        B BB      B    BB BBB      BB   BB    B  B  B B    
  BB      B B            BB BB B B      B     B         BBB    B    B B  BB      B B      B B B      
           B          B       B            B     BB  B       BB          B B         B B      B    B 
                B          BB         B     B      B      B B  B    B  B  BB            BB        B  
    BB     B B B      BB  BB      B       BB    B  B  B BB                    B  B       B       BB  
B    B  B     B    BB       BB B B  B B      BBBB     B    B     B                           B      B
   BB B  B      B       B   BB B BB  B         BB  B           B  B    BB              B       B     
     B   B  B B   BB B  B   BB   B      B B   BB BB                B     BBB   B   B        B        
    B               B    B  B          B         B        B                B       B B    B      B   
     B  BB  B     B    B     B  BBB B    BB B B    B  B                 B   B    B     B    BB B B   
                 B   BB BB   B B       B      B              B     B    B              B    B B      
     B B     B        B       B         B B BB    B   B   B           B     B  B B     B         B B 
       BBB     B   B      B      B B      B    B    B          B B      B     B   B   B BBB      B   
B B   B      B    B   B B BB                         B   BB B               B              B         
B         B              B   B     B        BB  BB        B          B  B          B B B     B B   B 
B                      B BB   B      B    B B  B         B B    B  B  BBB         BB    B  B         
 B B  B      B   B      BB  B  BB    B    B      B    B                  B  BB   B  B      BB       B
  BB    B B B   BB  BB B     BB             B     BB    BB   B       BB B  B    B     BB             
B B    B  B  B    B  BB      B  B    BB     B       B         B      B    B             B          B 
 BB     BB     BB   B  B  B   B          B   B B  BB       B   B B    BB        B       B B  B       
   A   B      B        B   B       BB         B B    B                        B           BB        B
B BB           B    B       B   B     B   B                     B            B                B      
      B      B   B     B    B      B    BBB       B BB             B   B     BB  B B  B B   B B     B
    B B    B     B           B             B           B  B  B  B BBB      B B     B       B   B     
    B    B    B B              B     B                    BB  B BB       B B   B   B B    B   BB     
 B            B                  B B               B  B       BB B B B B B  B   B  B BB  BB        B 
B  B       B      BB B       BB BBBBBB B      B B    B                B   B B   B B B    B  B  B     
B                         B   B                            B  B B             BBB   B B B    B      B
       B   B         B    B     BB            B    B        B B   B    BB  B            BBB          
B BB B   B        B   B  B  B         B  B   B   B B    BB  B                  BB      B B      B    
    B      BB    B B       B       B B  B      B             B B   B         B   B B    B   B  B  B  
         B         B    B    B  B    B      B    B    B              B      B   B B           BB    B
B      B       B  B   B   B              B   B B     B  B      B      B B  BB     B     B   B  B   BB
BBBB B  B B B      B    B              B             B   BB  B   B                 B  B B B      B   
   B        B    B   B   B B       B  B  B   B     BB B    B B     B  B    B        B      B   B  B  
  B     BB  BB BB   BB   B   B         B   B B BB   BBB B B   B     B              B    B        BB  
   B   B      B B        B    BB  B   B   B      B     B       B   B  B         B       B   B   BB  B
 B                  B B     B          B      BB        BB  B       B B BB  B             B   BB B   
 B B                 B       B        B   BBB           B  B                   B   B            B  B 
B     BB   B    B        B        BB              B          B     B             B               B B 
  BB    B     B      B    B   B   B  B   BB       B   B  BB     B         B    B     B B         B   
   B  B  BB  B   B  B      B      B B  BB    B    BB               B  B B        B BB   BB   B     B 
B     B                  B     BB       B   B  B B B       B      B             B  B  B B         B B
  B  B     B     B     B BB   BB      B   B      B B        B     B            B     B     B   B   B 
B B     B  B               B  B B BB       B B   BB   B           B  B     BB  B    B     B  BB B    
    BB  B        B            BB B B            B  B BBBB BB BB        BBB  BB                 B   BB
B            B     B      B  B B     BBB   B B   B      B        B   B     B      B B B B       BB BB
        B                    B B   B            BB  B B           BB                     BB BB B     
  B B BB           B B  B        B   B        B   B    B      B    B B BBBB    B   B  BB B B B  B    
    BB B            B      B                B  B      B     BB        B          BB B      B         
        B    B        B       B   B     BBB       B    B B   B          B    B B  BB B         B     
BBBB         B   B    B  BBB B   B  B    B     B    B                 B B  B      B                  
BB   B    BB     B B             B         B     B       B B BB      B     B    B    B  B        B   
         B            BBB       B B     B  B BB B  BB   B      B    BB    B  B    B         B  B   B 
    B       B      B   B      BB B   B              BB BB B B B       BB       B   B         B       
    B      B                 B       BB B  B    B B B  BBB   B    BB    BB      B       B     BB   B 
  B         B  B             B B  B                           BB   BB      B B   B   B B     BB  B  B
 B         B      B      B      BB  B     B B  B B             BB             B BB   B  B  B  B B    
B      B    B B   B                  B  B  B         B   BB BB BB    B B  BB BB          B      B    
BB     B        B     B                 B    BB         B  B    B     B           B     BBB B  BB    
          B B    B                BB   B  B    B    B                  B         B      B   BB BB T  
   B  BB    B    BBBB B     B B B B  B B     B     B   B  B            B              B   BB  B   BBB
      B  BB          BB   B  B     B  BB  B    B  B    B          B B    B BBB      B  B        B  BB
B  BBBB  B BBB       B    B  B   B B B         B                    B      B                B    B  B
   BB     B BB     B  B    B B   B      B B B    B   B  B   B  BB        BB               B       B  
     B         B    B           BB  B  B         B    BB        BB B B B      B            B   B     
  B B    B B B   B     BB   B  B BB    B       B B    B      B B       B     BB        BBBB B  B    B
   B    B      B          BBBBB      B     BB   B  BBB                   B B B          B            