 B                  B    B   BB      B        B   B    B B    BB B B B B        B  B    B  B   B     
B               B         B BB             B B B        B B  B     B     BB     B B             B B B
B  B  B          B B      B  B    B    BB  B     B   B  B   BB B BB   B                  B    B      
  B    B B B    B    BB                 B   B             B       B         B   B    BBBB  B    B    
    B        B      B      B   B   B B    B   B B  B   B    BBB       BB     BB   B  BB B            
BB          B        B   B         BBB B  B B      B     B   B     B      B         BB B           B 
B          B B    B                    B         BB B         B   B     B B B  B B       B B    BB   
  B  B B                  B B   B   B        BB     B B B B B B        B          B     B        B   
  B     B      B                      B    B       B   B    BB     B   B  B   B      B               
                  B B       B   B       BBB   B        B  B  B B   B     B      B B  BB  BB          
 B                 BB    B B  B  B B       BB           BB                B          B        B  BB  
B      B     B     BB             BB BB       B          B            B B B  B                 B     
B                 BB  B  BB     B B BB    BB    B  B           B       B           B     B     BB BB 
                   B B             BB    B  B B      B   BB  BBBBB    B  BB      B   B    BB B      B
         B      BB   B BBB        B B  B     B       BB BB     B   BB                                
B       B  B      B           B B   B  B  B B          B B   BB       B   B         BBB     BB       
          B   B      B BBB   B  BBB        B      B         B    B       B  B BB B  B    BB  BB B BB 
    B   BB      B  B      BB       B    B  BB   BB  B B           B         BB                    B B
  B    BB  B    B B    BB   B      B  B       B       B             B        BB B      BB   B B      
  BB       B B       B      B  B    B    B       B    B   B     B          B  B     BB               
     B B     B    BBB   B   BB  B          B B   B   B  B        BB   B   BB      B   BB BB       B  
         B      B BB  B   BB     B    B B   B   B               BB B     B B             B  B        
        B         BBB            B   B      B      B   B B     B B B  B                   B    BB    
  B           B          BBB   B B  B   B  B B  B         B                 B  B      B       B T    
     B BB         B        B B    B B  B     B  BB   BB          B B  BB        B        B B B  B B  
         B  B B     B    B      B        BB     B  B  BB                      B         B   B  B     
   BBBB B    B  B        B   B   B        B   BB        B           BBB         BBBB        B    B   
  B BB    BB      B B B      B    B    B                         B B   B  B          B    B   B  B  B
 B        BBBB     B B      BBB       BB  B BB         B  B     B     B   B B       B BB   BB B     B
B        B                        B    B  B     BB   B      B B         B B BBB   B  BB  BB      BBB 
 B   B    BB           B   B               BB          B  B      B            B       BB BB    BB    
     B         B   BB        BB           B          B      B    B      BB   B   B    B      B   B   
 B B            B  B     B     B           B    B    B  B B  B  B   B B    B BB    B          B B B  
 B  B   B   B     B BB                           B  B  B                 B BBB    B        B  B      
 B           BBBB      B       B  B BBB         B  B         B                        B   B       B B
    BB B        B   B   B  B B    B    B      B                 B           B  B B   B    B   B   BBB
       B        B       B B   B   B                 B B    B     B      B     B           B B     BB 
 BB B     B   B      B B            B B BB BBB        BB B B   BBB   B      BBB BBB    B    B   B    
     B  B        B B     B    B     B B          B BB  B      B       B   B BBBBB BB B               
      B  BB    B               B            BBB     B            B   BB  B  B B          B   B B   B 
          B B          BBB  B    B         B   BB           B     B   B    B      B        B         
 B  B     B  B          B  B  B             B    B  B       B B       B  B B  B        B   BB  BB    
B  B      B B     BB   B        B      B B    B   B         BB B B    B        BB     BB   B    B   B
    BB B   BB   B      B        B     B  BB    B    BB B  BB    BB      B                 B BB B     
 BBB    B BB             B        B      B B   B  B        B    BBB  BB B   B     B BBB B B          
A B   B      B    B      B   B     B B               BB           B          B B            B     BB 
     B   B  B BB    B B B      BB       B      B  B       B       B       B   B      B B        B    
       BBB   B  B  B                    BBB        B    B       B B                   B     BBB      
         B B        BB      BB     B        BB    B  B B   B   B       B  B    B     B          B    
 B      B    B BB        B   B   B B B      B       B  BB B    B           B      B    B  BBB      B 
B BB       B    BBB BB          B B   BB B BBB B        B B B   B  B  B B B    BB      BB BBB BB  B  
B   BB            BB   B  B   BB      BB    B   B B              B     B  B      B   BB    BB   B   B
B     B      B                   BB       B        B            B B   B B   BB      B B     B       B
B   BB       B  B         B B     B    B   B    B BB   B B           BB B B     B                    
B            BB      B   B                 BB B    BB     B   B B   B   B        BBBB B      B B    B
   B    B B   BBB      B     B    B B  B    BB B   B            B  B       B  B     BB   B           
B    B        B         B                                         B             B B         B    B BB
B   B     B    B  BB         B            B        BBB         B  B              B  B    BBB B B     
         B        B  BB     BBB       B     B B                 B       B B  B   B       B   B B B   
      B        BB    B B B   BB           B                           B  B          B      B  BB BB  
   B                  B      B  BBB  BB     B       B  BB BB     B  B  B    B           B B          
      B   B B        B    B    B B      BB B  B B    B   B   B   B      B          B                 
     B                B    B  B    B B B    BB       B BB         B B     B                       B  
 B           B     B                   BB  B         B B        B B  B   B B     B    BB   B  BB    B
  B B BB     B B        B B      B        B       BB           B BB B B   B    B B    B  B B B       
            B  B B    B BB B  B         B  B   B  B   BB B B      B B      BB    B               B   
     BBB            B  B               B     B              B B    BB    B        BB     BBB         
  BB BB        B                  B BB B      B        B B        B        B   B   B B BB            
  B    B B   B  BB   B             B           BB     BB      B    B   B    B       BB   B         B 
B B     BB B   B          B      B BB    B  B B                    B B    BB   B   B    B            
 BBBBB     BB B  BBBB  B       B   BB   B           B      BB  B B   B B    B      B                 
   B BB   B  B    B         BB                   B   B  B   B       B       B      B         B     B 
  BB    B         B    B      B        B BB     B   B          B           B        B  B       B  B  
     B    B    B     B  B BBB      B  B     B    B  B     B BB      B B B  B    B    B B   B      B B
 B B  B   BB         B       BB   BBB  BB B      B B      B BB  BB  B          B B           B       
 B      B B             B        B B  B  B B    B  BB BBB    B B B        B  B  B              B B B 
B B      B       B BB        B  B    B BB     B       B      BB   B      B     B    B B             B
B            BBBB                 BB  BB             BB     B            B          B    B B         
 B            B    B           BB B BB  BB  B BB            B          B   B   BB     BB     B     BB
    B  BB      B   B  B BB B  B  B  B            BB       B         B  B B   BB  B   BB  B    B B    
 B  B   B              BB   B BB   B    B BB  BB     B  B   B                       B    B        B  
B      B            BB B       B    B  B B   B         B     B  BB       B   BB     B     B  B  BB B 
B     BB      B    B       B    B        B       B             B         B B    B                    
    B          B BBBB   B B                   B   B          B              B B   B     BB B         
             BB    B      B           B   B BB        BB     B  B               B  B B     BB  BB    
             B B BB B     B  B B   B     B            B       BB       B BB  B B   B BB B  B    BB   
   B    B                    B BB         B        B  BB               B        B B           BBBB   
   B B B      B    B  B     B         B        B B B    B    B  BB               B B                B
        B  B   B B B      B B B B       B          B     B        B BB       B   BB      BB  B       
           B            B           B B   B     B   B B  B  B BB    B         B       B  B    B      
B   B                      BB  BB B     B                B     B  B    B         BB B                
                  B                      BB              BB B  B B B       B  B      B     B    B  B 
 B           B    B        B BB     BB     B  B B           B     B  BB       B         B         B  
      B                     B   B        B     BB B   B                B B BB   B   B     B         B
 B  BB     B   B B  B               B      BB    B        B                 B B B   B   B          B 
  BBB B   BB        B   BB  B    BB    B       BB        B       B   B   B       B     B   B         
       BB    B     B      B  B    B B   B  BB  B         BBB   B     BB           B   BB    B  B  B  
      B    BB        B         BB  B  B  B    B      B    BB B    B BB  B            BBB         B B 
     B    B B      B    B B  B                    B  B                 B    B   B B    BB B  B       
   B       B         BB B  BB     BBBBB    B    B  B   BBBB            B  B     B             B     B
  B            BB    BB      B   B        BB B              BB      BB B  B  B     B           B     