B    BBB   BB B          BB   BBB    B   B         BB            B  B        B   B BBB  B B   B      
     B    B BB B    B B BB  B B      B BB      B     B          B BB B        B B        BB BB BBB BB
     B       B  BB  B     B       B      BB  B          B           BB   B B   B BB    B B     B     
B     BB          B       B       B       B               BB    BB  B    BB              B B  BB  B  
B    B  B   B BB          B          B   B B  B  B    B          BBBB       BB             B      B  
   B    B       B      B    B B       B B BB  B BBB   B                          B  BB     B B   B   
      B     B  B  B           B    B               B   BB BB      B             BB B       B      B  
    B          B      BB  BB      B  BB   B B  B        B   B            B   BB  B      B B B        
  B  B      B     BB        B  B     B B   B        BB   B     B             B B   B  B        B     
 B    B          B B     BB BB     B      B     B       B   B         B                 B      B    B
        B     B B B         BBB   B    B              B   B     B      B     B    B B  B          B  
     BB    B B B              B B      BB   B        BBBB    BB    B  B       B   B B   B B BB       
     B B     B   B B     BB   B  BB      B    B      B B           B      BB  B BB         B      BB 
B B   B              BB BB  B           B   B              B       B    B        B           BB      
         B    B  B        BB  B   B B    B B  B               B     B B      BB B      B       B   B 
               B            B   BB       B   B    B          B  B   B B           B  B  B   B        
 BB   B       B B  BB B   BBB             B    BB BB    B     B        B      B              B       
                             B            B     BB     B  B   BB           B    BB             B  B  
             B B B  B  BB BB      BB           B     B               B  BB          B B      BBB B   
  BBB                         BB                 B   B B B B     B    B   B        B BB    B B   B  B
B    BB    B   B  B          B B                 B      B         B                B     B B B      B
    B B          B B    B  B    B  B B  B   B     BBB            B    BBB   BB    B BBB        B     
  BBB  B B B     B                 B       B B        BB           B    B                   B   B B  
    B       B  B B          B    B   B        BB B          B    BB  B BB      B        B  B  B  B  B
 BB BB                      B       B B   B        BBB     B    B         B  B              B        
  B  B      B  B   B  B        B B    B  BB  B   B               BB  BB     B  B   B  B        BBB   
    BB    B         B       B        B                       B                    B          BBBB    
BB  BB BB  BB   B BB        BBBBB     B B  BB           BB       B BB    BB  B      BB B     B B     
BB       B    B            B  B    B B  B     B    B       BB      B     B   B    B   B     B        
           BB B   BB  B             B   B      B  B  B         B   B  B          B       B    B      
     B  B      B        B    B               BB   BBB B    BB            BB        B B      B  B   BB
   B  B             BBB  B      B     B           B  B     BB    B  B       B B            B   B     
   B            B      B     B  B  B      B          B      BBB  B    BB      BB     BBB       BB   B
B  BB B        B  B    BB      BBBB   B   BB  B             B           B   B               B     B  
 BB       B B     B     B    B       B  BB     B BBB    B       B   BBBB   B    B B    B  B B       B
         B        BB          BB      B  BB         B             B          B    B    B B           
BB             B   B B     B B  B  B                                B    BB         B B  BB          
  B   B  B         B  BB  B    B     B   B    BB     B     B        B  B B       B B      B         B
     BBB  B           B    B B  B                B                BB     B   B        B       BB   B 
   B  B    B    BB         B   B     B          B   B     B B       B    B       BB   B              
      B   B    B     B   BB          B B         B   B                 B   B  B  BB     B    B       
   B                 B   B            B B  B  B   B    B BB  B      B      B      B  B    B B     B  
   BB      B  B    B           BB      BBB     B         BB     B B              B                 BB
  BB    B               B   B       BB    B    B  B   B  B   B           B   B  BB        B    B  B B
  B     B  BBB     B           BB     B        B   B  B  BB   B  BB   BBB    B        B    B  B BB   
  B      B    B  B      B BBB   B  B  B   B     BB     B B    B                 B             B    BB
B             B         B    B               B    B        B    B   B  B    BB                      B
 B   B BB         B   B  B       B   B                     B             B     B  B        B  B  BB  
     BB      B  B        B        B                     BB   B   B  B B B B  B        B   B     B    
 B    B    BB B              BB B  B       B   BB    B B    BB BB B           B B       B  BBB    B  
     B   B B     B   B             BB      B  B B       B  B B B              B                   B  
         B  B  B                B    B B      B  B   B         B       B  B    B              BB    B
       B  B B   B B  B  B   BB       B BB   B        B  B B      B B B B           B B  B   B  B     
             B BB B               B   BBB    B     B B  B         B  B           B    B   B   B B    
   BB     BB         B  B  B  B B      B                   B  B  BB   B      B B B B               BB
BABB         B         B      B    BB     B B    B     B    B BB  BBB BB BB  B   BB  B    B  BB      
     B B      B B  B       B    BB       BB                  BBB B  B B    BB         B B   B B BB   
 B  B     BB        BB B                B   B        BBB  B B  B B B  B  B B BB  B B B BB        T   
B   B   BBB  B         B  B    B B B        BB B  B   B        B  B   B B         BB  B  B   B       
                 B  B          BB          B    B B  B     B   BB BBB     BB             B           
  BB  B    BB            BB           BB  B     B BB     B          B                BB         B    
  B            B    B B      BB   B B B      B     B          B     B    B B B   B         B       B 
B              B         B     B  B  B         B B  B        B B               B   B B          B  BB
   B             B        B   B   B               B         B    B B          B B BB   B     B   B   
     B B  B  B BB BBB B     BB  B  B     B                          B    B   B    B      B B      B  
  BB          B   B B      B   B     B B  BBB              BB  BB B  B  BB  B     BB      B  B B     
    B      B       B  B     B B B B        BB    B                    BB B    B        B    B     B  
      B    B             B   B    B B   B B      B                   B     B          B     B      B 
                 BB      B          B       B B   B    B    B B     B   B     B   B          B B     
      B    B            BB          B    B      BB     B               B   B B       B  B  BBBB      
     B B     B       B     B B B      B B       B B              B  B         B B        B           
    B                    B             B    B   B B B  B    B B      B B  B                          
     B   BBB       BB      BB   BB B     BB         B      B            BB B    BB B  B   B        B 
B  B    B B  B BBBB    B      BBB   B   BB    B              B     B BB    B  BB   B       B         
B B   B   B       B  B    B   B      B   B             B    B   BB             B B    B       BB     
       B     B           B      B     B               B    BB B                 B                    
  B       B      B     B B   B   B  B B        BBB  B           B   B                  B   BB  B B   
B    B     BB   B B  B    BB    B   BB B   B  B  B   B B   B  B    BB B    B                  B   B  
    B  BB       B  B  B         B     B  B      BB     B            B   B   B        B  BBB          
             B     B  B   B             B   B                 B    BBB B       B        BB         B 
B B      B           B       B B  B        B   B     BB B B   B    B        B    B   B         BB  B 
      BB  B      B B   B         B B           B     B   BB            B        B           B B    B 
           B B           B B B BB   BB   B        B   B            BBB  B   B   B            B       
  B       B   B          BBB   BB B      B      B           BB     BB      B  B  BB B B  BB          
    B B B   B B       B      BB    B  B         BB   B B           B        B B     B    B     BB   B
 B  BB   B             B   BB     B  BB       B           BB    B                    B    B    BBB   
           B   B   B   B B                 BB              BB  BB     BB BBBB   BB           B B     
                        BB      B           B B        BB                      BB  B               B 
  B      B     B  B     B B     B      B               BB    B     BB BB  B  BB    B B      B     B  
B        B B B      B  B    B  B       B   B    B     BB             B          B    BB BB  B   B B B
  BBB B               B  B  B           B B       B   B     B   B    B  BBB          B      B    B   
    B               B   B     B          B         BB  B  B     B       B            BB B   B        
B                      B           B     B     B  BB     BB B  B  BB   B      B B               B    
              B      B      B  B  BB B  B BB       BBB   B  B   B        B        B       B     BB  B
     BB B  B B  B        B               B   B  B BB  B  B     B                B      B        B B  
   B         B        B     B   B B   B B      B      B            B             BB  B   B      B B  
B   B B B  B    B B          BB  B   B           B B      B                  BBB  B     BB     B BB  
      B        B     B   B         B  BB       B  B           B  B          B         B        BB    
          BBBB     BB B   B  BB   B    BB    B   BB    B    B      B B      B  B   B   B             
B    B      B          B           B    BBB   B B B B   B B   BB     B  BB  BBB                   BBB
        B    B  BB    B  B        B      B    BB  B   B  BB  B           B   BB  B    B B  BB    B BB