BB    B  B  B B         B  B   B          B  B         BB    B     B BB        B  B BBB   BB B   B B 
B   B   B    B       BB    B B    B  B  B         B      B  BBB  B B          B      B   B    B B B  
        B   B    BB    B B    B BB   B    B  B         BB  B     B  BB   B            B   BB    B BB 
         B                B   B    B BB       B    B            B      B                B     B      
   B B BB     B  B     B       B B  B B B   B   B B  B              B  B            B   B          BB
 B  B    B     B         B            B              B      B  BBB                        B    B     
            B       B         BB           B  BB   B B         B    B  B   BB  B B  BB   B       B  B
  B  B B      BBB  B         B                      BB B       B     B B   B       B      BBB    B   
 B                    B    B    B  B    B BB  B    B   BBB   B         BB       BB       B   B    B  
         BBB    B   B  B  B                BB    B  B    B B       B             B B              B B
    BBB          B B  B              B          B     B        B B   BB  B      B   BB   B          B
 B B B  B B  B       BB         BB   BB  B   B     B                       BBB   B B           B     
   B   B         B      B         BB B          BB     B    B  BB         B  B     B B B      B    B 
 B       B  B      B               B               B B   B  B  B         B  BB               B    B  
               B  B    B      B B B  B                      B   B                         B       B  
AB             B          BB   B       BB      B B   B BB    B      B    B     B   B B      B      B 
     B    B   B      B      B B BB        B        B        BBB  B        B      B B    B    B B     
  B      BB     B        B      B    B    BB          B   B        B  BB              B    B      BB 
            B    B BB       B    B               B     B         BB           B  B    B  B  B        
 B  B B    B B      B      B             B               B B    B   B                 B             B
 B  B  B       B      BBB          B   BB B  B      BBB  B   BB       B             BBB      BB BB   
   BB      BB  B   BB B                    B   B  B             B B        B    B    B   B    B      
B     B B  B   BB            B      B    BB   B B   BB     BBB    B   B B   B  B  B      BB       BB 
B   B           B        B   B    B   BB   B              B  B       B     B         B      B     B B
               B             B           BB  B       BB   BB       B    B B  BB BB   B     B    B    
 B    B              B  B   B  B     B        BB     B B BB           B                       B BBB B
       B   B   B   B    B B           B    BB   B          B    B        B       B  B   B  B   B     
 B    B B       B B B BB    B  B B   B       B  BB BB        B   B B                 B   B  B   B  B 
 B                  BBBB    B        B   B    B B           B   B    B         B       B         BB  
    BBB      B B    BB           B         B   B  BB    B  B          BB   B    BB   B   B  B  BB    
B  B B   B  BB      B        B   B   B     B B  BB  B  B     B      B                   B        B  B
B      B      B  B    B B   B B    B   B  BB    BBB     B B    B     BB  B  B  B                     
 B B                          BB  B      B                    B B     BBB  B   B               B     
   BB    B            B  B      BB            BB       B B B  B B     B B B         B B B     B  B   
           B      B   BB B     B               B        B B       B     B     B  BB BB    BBB B      
         B    B  B        B      B  B        B          BBB   B     B                 B    B         
         B   B      B B     B   BB         BB     BB          B     B        BBB  B BB  B   B B      
   B B B    B B        B      B       B          B    B   B        B         B B    B B     B   BB B 
  B          B              B     B     B   B   B B            B   B  B          B B       B         
 BB    B    B     B B  B         B         B          B   B                B B B      B   B  B     B 
        B  BB  BB  B    BB   BB          B    BB     B B           B B  B   B B   B           B B    
  B B B   B   B               B      B        B  B   BBB  B  B         B          B    B  B     BB B 
       BB       B    B B    BB    B        B             B      B        B BB   B     B        B     
                            BB     BB  B   B  BB                          B       B           B BB   
 BB         B        B  BB          B   B  B    B   B B   B  B B         BB  BB BB                  B
 B           BB B B   B  B B                        B  B BB                   B   BB      B   B      
    B  B B          BB   B B           B BB    BB    BBBB    B B    B B  B   B     B    B       B   B
 B   B     B   B  BB B     B  B                      BB      BB  BB         B B       B  BB BB     BB
B     B B  B      BB       B      BB B B        B      B      BB         B   B     B  B   B    B   B 
      B                 B BBB     BB   B     B   B B   B     BBB        B     B   B      B      BBB B
B           B      BB        B         BB       B   B              B B    B   B B         B         B
      B  B B    B                    B   B    B       B                        B  B   B  B      BB B 
     B         B        B           BB       B    B    B    B B        B      BBB             B    BB
B   B B      B B   B       B    B    B  B       B              B         BB  BB    B     BBB         
        BB   B                        BB BB B  B        BB           BBB     BBB    B B B   B    B   
 B   B             B     B       B     B      B B          B      B      BB  B  B   BB B  B         B
   B           B  B   B B     B           B   B           B   BBBBBB   BB   B  B   BB  B   B B  B  B 
  B    B  BB B B                 B  B   B   B     B        B           B              B   B B B B  B 
 B            B   B B   B    BB   B B   BB  B  BB  B        B   B B       B     B      B  B     B   B
   B                B B B B               B            BB     B   BB   B       B              BB     
    B      B B         BB  B  B B   B B      BB                B  B B B   B  B       B   BB          
   BB      B                  B B  B      BB      B  B  B   B B             B     B  B B   B         
         B  B        B B       BB  B      B     B BB   B           B  B   B  B BBB  B  BB    BBB     
    B B           BB       BB      B   B     B        B        BB     BB            B       B BBBB   
  B   B  B     B   B       B     B B  B      B   B BB       B             B   B    B B       BB  BB  
 BB      BB       B       B  B     B B B         B        B     B                           B   B    
        B BBBB   B       B    BB   B  BB   B   B BB B             B              B    B   BB B  BB B 
  B BB      B   B B B  BB       B   B  BB       BB BB   B   B  B    B B    B   B          B          
    B      B   B         BBB     B       B   B B   BB  B    B   B   B B        B     B     B B     B 
     B   B      B        B BBB B  B        BB   BB B B      B  B  B     BB BBB        B   B       B  
    B B        B  B  B    B   B  B B B     B  B B         B B B   B B     B BB          B B      B   
    B  B B B            B   BB           B      B                B   B           BB    BB     BBB BB 
       BB BBB  B    BB     B     B     B   B BB              B                             B    B    
     B          B        B  BBB   B         B  B   B  B          BBBB      B   B   B   B    B    BB B
  B     B    BB B     B  BB       BB        B   B B       B  B B          BB    BB B                 
 BB    B  B BB  B  B  B              B   B   B B B       B     B B B     B    B    BB B  BB B  T B  B
   B       B  B         B  B B    BB        BB BB B B           B    BBB       B      B  B         B 
      B      B        B BB B         BB    B B   B         B                 B  B     B   BB      B  
     B              B        B B B  BB       B         B               BBB    B           B  B     BB
       B  B          B                 BB      B      B   B                 B  B     B B  B B     B B
   B   B   B     B   B    BB   B  B B    B     B      B B         B    B            B B        B     
       B  B B    B           B B  B BB       B    B    B     BB   B       B    B   B      B      B   
    B    B  BBB B   B B  B    B    BBBB  B                      B              BB    B BB B   B   B  
B        B    B   B      B          B   B  B    B       B   B     BB     B            B   BB B       
    B     B   B B  B    B          B           B   B B    B  BB    B     B  B       BB     B BB B    
B   B       B    B           B   B                        BB   BB B   B   B  B                      B
 BB     B B B  B    B         BB     B    B   B  B              B     BB  B   B   B B           B BB 
       B   B  B    B B       BBB B B  B B BB      B   BB B            BB  B  B B                    B
  B      B           B       BB        B B    B        B         B           B B BB   B         BBB  
 B B B   B     B B   B B   B       B B  B B     BB   B                B B    B        B  B        B  
 B   BB B  B      B  B   B B B      B     B    BB B B  B    BB  B    BB  BB       BB  B    B   BB   B
  B  B   B   BB         B   BBB       B B                B         BB   B BB   B       BB        BB  
B          B  BB B B      B B    BB B    B        B     B B     B     B B          B   B B  BBB     B
    B        BB        B      B   BB   B                BB        B  B  B         B    B      B    B 
B B             B   B       B       B          B B              B                B    B  B     B BB  
B             B              B B    B     B      B      BB        BB  B BB  BB               B       
 B    BB     B BBB  BB  B   B  BB BB        B    B BB     B  B  BB  B     B B      BBB               
                B            BBBB    BB  B B B B B B      B         B  BB         B       B          
    B    B      B       B      B  BB  B      B                    B    B    B B  B         B B B     
                B   B         B               B   BB B          B     BB             B  B  B     B  B
   BB    B      B    B     B  B     B B                   B  BB    BB                B   B       B   