  B       B            BB      BB       B      B  B   B B B               B   B B        B  B B   B B
         BB              B  BB   B B      BBBBB      B   BB       B  B           B   B  BB        BB 
  BBB   B B   B    BB          B B       B     B B       B                          B         B  B B 
B   B B         B BBB             B         B     B    BB  BB    B    B   B  B    B    B         B   
BB           B        B   B       BBBB    B       B BB    B   BBB  B        B   B        B     B    B
       BB    B     B    B      B      BB        B              B B B BB B  B    B   B  BBB B      BB 
   B    B    BB B   BB B   B B      B             BB    B  BB B    B         B B  B       B         B
      B   B    BB                      B    B          B                 B B      B  B       B      B
  B            B  B   B    B       B    B                       BB         B        B B  B           
 BB B B     B  B    B   B          B    BB B  B     B  B BB          B        B                 B    
      B B    B  BB     B       B      BBBB    BB B   B  B  B       B  B        B     B     B         
            B    B  BB        B    BB       B    BB B  B  BBB BB       BB  B B  B   B             BB 
       B    BB             B B B        B B      B B             BB     B  B  BB         B B B    B  
    B BBB   B B      BB B    BB      BB B   B     B        B  BB      B     BB B  BB   B    B B   B  
 B B  B    B      B           B  B     B            B     B       B   B BBBB     B        B B B BB  B
     B B       B     B                B   B  B    B B   BBB       B   B     B  B          B  B    B B
   B       B    B B                 B B    B   B   B B    B       B  B   B      B           B        
B  B BB                B               B  B        BB  BB      B     B   B        BBB         B      
BB     B  B   BB              B             BB B               B B BB      B                 B    B B
 B   B    B BB      B      B             B B      B   BBB     B     B      B             B      B    
   B      B B  B BBBBB   BB       B         BB             BB  B    B    B           B     BBB       
  BB B B B           BBB  B  B B    BB        B                B B      B BBBB   B      B         B B
     BB     B     BBB     B    B B           B       B       B  B                  B   B             
   B                      B B    BB B B  BB B B     BB            BBB        BB B    B       B  B    
B     BB  B B   B B    B      B  B B      B           B     B B B   B   B        B    BB        B    
   B  B       B    B       B  BB       B  B B          B   B    B B      BB  B       B  B            
  BB    B  B BB      B            B  B B  B  BB       BB    B     B B  B  B  BBB   B    B            
   B         BB           B   B                B  B       B B  BB    B B      B  B       B     B   B 
    B     B     B  BBBB B  B  B           B B  B         B       B    B           B        B    B BB 
     B      B       B B  B    B              B  B    B  B    BB B B   B     BB B     BB     B    BB B
         BBB        B B  B B   BB  B  B                   B    B      BB     BB  B        B  B      B
B            B                 B    B   B  B B     B  B    BB    B B    B          B   B B      B  B 
B       B         B          B      B   B      B               B  B  B B    B      B   B             
     B         BB         BB    BB  BB        BB  B     B  B B    BB           BB  B   B   B     BT  
        B  B  B     B       B   B             B             B   B        BBB       B  B        B   B 
B      B  BB  B     B      B  B B       BB    B B        B B         B         B B  B  B      B      
          BB                     B B B B                         B    B      BB     B       B     B  
B   B       B    B           B           B  B  B  B     BBB   BB B      B  B    BBB     B    B B     
  B     B       BB B B    BB     B   B       BB  B B            B   B         B           B B   B    
B       B   B       B B  B BB  B B   B    B  B     BB        B     B   B      B        B B    B   BB 
 B B     B          B      B B  B  B            B    B B B BB   BBB           BB     B   B     B  BBB
  B   B  B       BB         B  B    B  B  B         B B    B  B B   B   B        B B                 
    B B      B        B      B       B         BB B     B  B     BB    B      BB  B B B      B B     
  B       B B BB   BB    B    B       B       BB   BB     B  B  B    B B  B B   B        B   B  B B  
      BB      B B  B B       B         B    B  B   BB   B  B  B   B            BBB  B  BB       BB   
B     B B     BB    BB B          BBB  BB BB                   B  B      B          B    BB          
B       B         B  BB    B BB     BBBBB           B       B  B               B        BB  B  B  B B
      B      B BB     B            B    BBB          B  B    B  BB  B           B BBB         B    BB
  BBB    B   B    B  B      B       B  BB          B     BBB                         BB     BB       
   B    BB    B          B B        B B  B     B  B     B      B      B BBBB    B         B      B B 
  BBB       BB              B   B      B     B         B  B    B         B  B B     B     BB         
B      B      BB   B   BBB                 B   BBB         B     B        B        B      BBBB   B  B
   B       BB   B          B B           B     B  B  B  B    B B  B   B  B  B    B        BB         
    B  B       B   B   B       BB  B      B  BB         B B B  B B  B                     B    B     
 B B      BB B  B            B B  B  B           B B      B    B            B      B    B B    BB    
 B   BB  B            B        B     B BBB B    B B B B    B      B B   B  B  B B              B     
     B    BB  BB     B  B B       B  B     BB        BB  B   B         B     B      B       BBB B    
       B            B       B    B        B                 B     BB      B    B BB BB             B 
 B B    B BB     B  BB  B   B   B       B B      B     B   B    B     B B B      BB  B    B    B     
 B B B  BB BBB   B   B            B   B             B               BB B             B B             
   BB                  B B     BB   B    B B   B B          B  B  BB    B   B B     B B     B  B     
B B  B         B   BB    BB             BBB             B B        B   B   B            B     B      
 B  B                        BB       B        B  B B      BB B B B  B       B  BB B        B  B     
B  B                           B  B B       B B     BB B   B  B B        B  BB    B      B        B  
        B    B        B  B    B  B B    BB BBB    B  BB  B    B     B           B     B      B       
   B         B B  B B  B   B B  B               B                 B     B                  B B BBB   
      B      B     B     BB       B  B           B B B                            B  BB          B   
  B  BB                 B         B  B   B     BB   B           B   B   B B              BB          
    B      B   B                BB B       BB B    B   B   B             B  B             B BBB      
           B     B  B           B                   B B      B   B    B       B    BB     BB B       
B BB             B  B   B  B  B          B       BB B    BB    B    B       B    B           BB      
           B  B B    B     BB B          B            B      B B        BB B B     BB                
        B BB  BB   B B   BB     B        B   B B B B           B B B    B              B  B          
BB  B   B  B            B   BB          B BB  B B  B  B     B B              B     BB                
   B     B      B    B   BB   B        BB B   B     B   B                    B  B        B  B BB   BB
      B      B B    B B            B B BB             B    B   B   B B  B    B B  B           B   B  
 AB B  B B    B           B     B   B   B   B    B            B  BB               B             B    
 BB    B B      B B         BB  BB  B  B  B BB     B B   B B                 BB    B   BB         B  
B     BB B B       BB         B     B B B     BB  B     B B          B    B                  B  B   B
B B B       BBB     B       B          B         BB      B      B        BB        B                 
   B    B    B B    B BBB B      B    B B BB          B           B  BB  B B   B      B  B BB B     B
      B     B  B           B    B      B   B   B BB     B     B  B    B        B     B            B B
                  B                    B B          BB B                                   B         
      BB  B  B      BB       B BB             BB             B   B    B    BB    BB     B            
B           B    B B        BB  B      B        B BB                  B BB        B     B   BB  B   B
      B BBB         B B      B        B  B   B  B                BB     B         B B B B B    B  B  
        B BB       B    BB   B BB B    BB     BBB     B  B                B     BB  B     B BB       
B  B                    B        BBB                                B      B         B BBB    B    B 
    B        BB B       B     B B B       B     B B        B          B     BB B BBB  B B       B    
BB        B     B      B          B     BBB BBB          B           B     B   B      B    B   BB    
   B          B  B  B  B  B  B              B        B B    B   B  B              B      B  BB   B  B
  B B      B        BB      BB  B           B   B   B       B          B  B       B B     B          
 BB            B               B       B B  BB                        B  BB    B  B    B   B  B    B 
       B  BB     B B         B            B   B                 BB B         B BB B BB       B  B  B 
               B      B       B   B B  BBB    B   B   B                      B  BB     B      BB     
B  B      B B  B    B  BB     B      B  B BB  B B B               B   B     B  BB   B       B        
   B        B    BB       B         B   B   B     BB    B B       BB    B   B B  B B BBB             
   B  B       B       B   B    B     B  B B  B    B    B BB  B B   B   B    BB   B  B        BB B    
  B   BB         BB  B     B   B  BBB           BB B      B B BB BB    B             B      B        
 B           BB                BB    B      B       B B B       B       B           B       B    B  B
  B      B    B         B     BB  BB   B                         B   B B B                  B        