BBBB    B   B      BBB         B  B  BB  B                B    B         BB       B BB   B           
   B        B     B       B      B    B B      B            B B B       B      B   B       B    BBB  
          B B BB B   B  B     B  BB               B        BB   BB           B  B     B          B   
     B  B    B               B     B  B         BB   B B    B     B          BB       B      B   B   
        B    B          B           B  B    B B     B         B    B   BBBB       B        B     B B 
 B             BB    B B    B      BB      B B             B    B          B  B  BB              B   
 B              B BBB  B     BB   B    BB  B    B B    B B B  B               B    B B     B  B      
      B     BB   B B                B B   BB     B   B        B   B              BB    B  B   BB  B  
   B    B B B      B B   B  B            B          B B     B          B  B   B            B         
B    B       B    B   BB BB    B  B B          B     B B B     BB  BBB  B    B       B B       B B   
              B    B        B   B          BB              B   B  B B B  B           B           B   
  B   B  B B       B    BB  B B    B            B B       B B        BB  BB B   B BBB  B             
      BBB B BB  BB BB         B  B  B       B BB B B B  B          B   BB         BB B B             
  BB  B             B       B    B           B    B BB                   B B     B  B    B B   BB    
    BB B              B B B  B   B    B  B   B B      BBB    B   BB BB BB          BB   B          B 
 B BB     B     BBB   B            B          B                  B                B  B               
                    B  B          B BB  B B     BB  B BB       B  B     B  BB    B                   
     B                    B  BBB  B B    B      B          B      B      B   B  B  BB   B    B       
 BB     B B  B  B   BBBBB   B   B  B        B  B           B              B B BB          B    BB    
          B      B         B   B  B  B  B B       B    B    BBB      B  B B    B     BBB      B  B B 
   B     B  B B      B  B        BB B     B         B B B      B                             B B   B 
   B   B B       B     B        B  BBB B        B  BB        B B                 B B   B             
 B    B B            B  B   B B    B B        B       B      B    B   BB   B    B  B   B      B   B B
         B                    B     B     B    B B      B B  B B      B B     B         B   B   B    
 BB     B           BB               B  B B       B   B BBB          B     B  B    B                 
     B BB B          B     B          B        B      BB B  B    BB   B BB B            B    B       
   B        B B     B              BB   B       BB         B                      B        BB  B     
        B      B              BB          B  BB   BB         B    B BBB  B      B        B B  B      
B       B    B   B BB            B         B  BB  B          B  BB BB              BB  B      B B B  
BB      BB                     B  B  BB     B BBBB B   B B         B BB      B    B B              B 
 B    B BB        B  B B        B  B B      B B       B       B      B     B B               B    BT 
BB   BB          B  B  B   B    B      B         B   B    B   B       B       BB        B B     B    
         B B   B    B    BB B B      B  B     B    B                     B           B BB  B B BB    
             B  B    BBB          BB      B BB      B   B       B   B       B   B       B  B     B   
  B         B         B     B         B BBB B B   B                   B           BB    B B    B     
  B  B    B        BB B       B B BBB B      B   B B    B    B  B  BB   BB       B B           B     
  B    B   B                  B   B     B     B   B   B        B    B     B         B BB       BB    
  B  B        B   BB     B   B    B B     B  B    BB B   BB        B      B         B         B    B 
 B      B  B  B B                 BB     B      BB B   BB  BBB B   B              B     B          B 
 BB  B                             B        B  B       B   B B         B         B       BB BB       
  B         B      B    B     B                 B        B B     B B        B     BBB    B   B      B
 B     B        B  B            BB        B  B    B      B   B     B   BB       B     B           B  
B     B  B               B       BB        B       B     B   B B  B   B        B                  B  
 B   B       BBB B          B   B BB    B        B             B B          B  B   BB       B  B   B 
      BBBB   BB   B    B  B  B     B  B  BB     B     B  B    B         B  B        B B  B   B     B 
  B  B BB   B   BB    B          B    B   B   B       BB         B   B    B   BB           BB     B  
    B                 B        B  B B         B      B          B    B               B      BB   B  B
         B  B   B  B  B  B      B  B            B  B  B   B  B   B B      B  B     B B           B   
B           B  B  BB       B B      B    B B     B        B               B    BB    BB  BBB B B   B 
 B B    B BB        B   B  B      B           B          B    B B B    B      B      B B  BB  B      
 B B   B   B B   B   B          B B             B     B B         B   B B B      B B     BB     BB B 
   B     B B  BB     B              BB B           B    B       B     B        B    B           B   B
         B  B   B     B       B BB   BB   B  BB B               B   B B   B B   B            B  B  B 
  B  B                 B       B B  B B    B        B B      BB    B  B  BB            B B B   B     
  B  B   B           B    B   B  B B      B  BBB       B     B       BB B    B   BB         B     B  
                               BB B     B    B B B   B      B  B                      BBBBB  B B    B
     B     B B     B   B           B        B    B     BB  B       B  BB  BBB      B     B        B B
 B B B   B    B      B   B  B B          B                 B       BBBB B     B  BB  B  B      BB  B 
 B  B B   B   BB B    B       B  B    B   B  BB   B B B     B     BB  BB        BB B                B
    B                                    B         B         B B       B B BB  B   B            B  B 
         B  B   B B             BB B    B    B    B   B B  B  B B     BB  BB           B             
      B B          B     B   B       B    B    BB      BBB B    BB B  B      B   B   B  BB B     B   
  B    BBB           B                B  BB  BBB   B   BBB B BB   B    B   B          B   B       B  
     B  B    B BB  B  B     B         B    B           B  B     B  BBB BB BBB B    B     B   B B B   
  B        B              B   B           BB   B BB       B       B BB             BB     B   BBBB  B
        B             BB         B          BBB BB  B         B     BBB        B B   B B             
    B B    BB    B  BB  B       B   BB B       B              B  B    B    BBB            B  BBB    B
  B             BB          BBB    BBB B            B B       B   BB    B  B      B             B    
   B    B B   B B     B     BB      BB  B    B          B             B   B              B      B    
     BB B    B    B  B  B   B             BB BB B B  B    B     B          B   BB  B B  B      B BB  
BB  A     B B B         B    B     BB     B    B B   B   B       B  B BB                       B B   
  B  B    B B             B     B      B  B     B      B       B    B     B  BB B  B  B BB    B     B
 B BBBB      B    B   B   B   B       B      B       BB B          B      BB    B        B   B       
 B B               B  B   B BB           BB           B      B B                            B        
 B  B  B B BB B  B      BB       B             BB   B        BB             B            B        BB 
    BB  B       B B B   B    BBB  B BB             BB       BB       B B  B    B       B        B BB 
   BB   B        B     BB B  B B BB   BB     B  B           B  B    B BB               B      B  B  B
  BB     B BB  B   B       B   B     BBB  B        BB      BB        B   B  B    B       B     B     
 B BB  B     B    B      B  B   B  B    BB  B  B   B       BBB     BB   B BB  B  B      B B          
B          B               B    B    B    B B     BB    B    B      B               BB  B         B  
 B B      B   B B     B       B   B     B                       B         B       B B B          BB  
  B B  B B     B  B B   B B      B        BB   B         B    B        B   B       B       B B   BB B
     B  B              B B      B    B B B   B     B B   B          B     B B B  BB    BBB         B 
     B        B      B     B B B   B        B   B  B  B    BB   BB         B                B       B
       B     B              B  B          B         B   B        B       B B  B B   BB       BB   B  
   B         BB    B       B      B   B   B   B   B B B   B         B B   B      B BB  B   B B   B  B
BB     B   B     B    B   B   B     B         B     B        B      B   B  B  B  B     BB     B B    
  B BB   B   B B B            B     B   BB BB      B  BB  BB           B   BB   BB     B         B BB
  B       BB   B B B        B       BB   B           B B  B  B        BBB   B     B       B B  B   B 
  B  B          B B B   B  B   BB  B BBBB B    B B      B B     B     B     BB B      B  B     B     
       B      B B BB     B B  BBB BBB B                    B  B      B     B B        BB           B 
 B BB   B  B B     B   BB   BB             B    B          B     BBB      B  B           B      B    
B  BB     B B           B B     B    B            B               B B  B B      B B  BBB      B  BB  
     B BB        B  BBB    B    B  B BB    BB     B              B     B  BBB  B      B  B  B        
 B        B         B      BB  B  B               B    BB        B         B                B B B    
  B B     B  BB    B     B       B      B   B B B     B  B  B    B  BB     B               B     BB  
      BB   B            B  BB          B         B  BB        B   B                B       B   BB    
           B   B B   B   B             B    B    B B   B      B     B                  BBBB  B       
    B  B     B              B B B    BB  B        B            B  BB           BB B    B    BB     B 
  B               B  B        B   B      B BBB B          BBB           BBBB   B  B   B B            
 B              B  B        B BB B       B  BB B B B     B   B   B    B  B      B                    