B    BB       BB B  B   BB    BB B  B    B       B  B            B   B BBB            B            B 
B BB B       B   B  B    B     B             B  B     B   B  B             B   B    B B  B  B B      
   B  B B  B   B    B     B B    B     B   B     B BB    B  BB     B BB B  B    B    B  B B    B     
B                   B  B   B B  B   B        BB B    B B   B    B  B     B   BBB             B  B   B
  B  B   BB B  B  B B   B     B        B                B    B       BB   B      B  B  B   B B       
B         B  B        B B  B  BBB    B         B           B      BB        B B    B    B     B      
BB     B   B     B   B  B B     B                  BB     BB  B         B     BB  B B       BB    BB 
                           B BB B       B        B      B   B     B     B  BB  B B      B       B    
     B   BBBBBB              B   B B   B  B       B     BB B BB B BBB BB B       B       B     B B B 
 B B        BB B   B    B          B  B    B   B         B   BB B      B   B  B          B  B  B  B  
 B  BB     B    BB B BBBBB         B B BB           BB      B  BB  B         B              B B      
   B   B   BB           B BBB   B         B B B       B      B     B BB  BBB B B    B B B B B    B   
  B   BB       BBB  B        B               BB   B B   B   B          B        B        B B   B     
   BB         B      BBB     B      BB    B       B   B    B      B       B                          
      B  B  BBB      B      B   B             B  B         B   B   BB           B         B       B  
 B  BB       B      B  B   BB B               B       B         B BB B    B  B        BB     B   B   
 BB        B     B      B    B     BBB BB         B  B B                B               BB          B
   B  B B     BB BB    B B       B     BBB   BB      B  B B  B      BB   B      B   B          BB B B
  B            B BB  B                  BB   B  BBB      B      B B         BB     B     B B  BB     
   BB B       B           B      B  B    BB                 B  B     B B    BB  BB           B       
    B         BB        B        B BBB  BB            BBB  B  B     B B B      B    B       B B    B 
  B       B            BB  BB             BBBB   B  B        B   BB                      B  B  B     
    B     B     BB          B            B   B B B    BB  B        B            B  B   B  BB      B B
            B B  B        B     B       B   B B            B    B  B       B       BB B      B       
                 BB  B       BB    B BB      B            B           B   B                   B      
B       BB    B                   B  B B       B  B      B   B  B        B          B              B 
B B     B                 B  B    B          B      B B   B        B           B        B       B  B 
             B                     B     B                 B            BB   B        B   B     B    
   BB            B B B  B B            B B  B      B    B          B   BB     B  BB    BBB B         
    B BB        BB  BB B  BBB B         B B   B   BB    B B             B     B   BB          B      
B                                      BB     B          BB   B     B               BB               
  BB          B   B           B    B       BBBB   B      B         B     BBB B  B B         B    B B 
BBB        BB B   B      B B BB   B   BB      B         B    B         B  B BB BB B   B     B        
      B          BB      B            B  B      B   B      B B   B       B  B  B BB    B  B          
  BA       B                                B      BBB      B   BB     B   B  BB  B    BB            
        B    B     BB             B       B  B B      B     B                     BBB    B        B  
B   B    B   BB  B       B        BB  B B   BBB      B    B B     BB BB   B  B      B B   BB         
  BB    B        B B   B      B   B B    B      BB                B      BB  B   BB        B         
           B  B B B B           B      BB  B  BB B B B      B                B       B    B  B       
  B   BB         B B          B       B B  B      B    B BBB                B B   B B  B B  B    B   
       BB   B     BB                    B         B                 B    B     B   B   B           B 
 B  B B           B  B   BBBB    B    BB BB          B     B     B B       B B    B      B  B     B  
 B    B                      BB     B       B B BB                  B BB B  BBBB   BB                
      B  B  B     BB       B                       B BB      B  B B  B           B          B   B    
      B  BBBBBB        B  B                   B B           B      B     B         B  B              
     B  B   B   BBB B BB   B     B    B  B    B B   B    BB       B    BB       B     B  B B         
 B              BB      B B        B     BB     B     B   B        B   B  B        B  B BBB          
 B           B       B    B B         B    B       B  B  B  BBBB   B B  BB     B        B B      B   
B   B BB      B   BB B    B    B B      BB    B   B  B  B B BB       B   B  BB            B          
     B         B        BB  B          BBB B       B         B     BB      B                    B    
  B  BBB    BB       BB   B                       B       BB   B     BB B B    B  B BB   B     B B   
        B   B   B     B B       B         BBB  B BB  B    B      BBB   B         B     BB B         B
            B    B      B   B  BB  B    B  B   B B    B  B     B   B BB     BB     BB  B B   B  B    
 B     B  B   B      B B      B BB   B B        B                    B    B            BBB     B     
 B                 B    B  B      BB B  B  B B B   BB  B B         B B       B       B               
B     B             B  B    B  B      B            B BBB     B          B    B   BB  B               
            B B BB  B    B   B        B  B B      BB       B       B    B B     B  B      B    B B   
    BB B    B                 B       B  B   BBB    BB B  BB    B    BB      BB  B  B              B 
B   B        B          B  BB         B  B B  B    B           B B  B      B    B     B BB     BB B  
 B B   BB   B B       BB   B   B      B        B              B   B         B    BB      B    B      
  B         B         BB       BBB  B      B B   B                       B B   B BBB B     B    B    
        BB    B   B        BB  B BBBB      B   B BBB   B       B      B      B        B B           B
        B   B BB  BB B B B  B  B  BB   B  B B     B BB             BB          B   B    B   B   B    
 B   B  B       B                  BB BBB             B   B       B   B     B    BB  BB         B   B
B B            B      B      B  B      B  B B  B BB  B      B B                  B  B        B      B
 B BB  B       B        B  B          B          B   B B      BB   B B   B     B B B      B     B    
B   B     B B          B     B   B          BB     B          B B    B B     B    B   B           B  
  BB  B        B         B     B       B         BB           B      B   B      B     B      B       
  B   B   B  BB  B             B B            B       B            B BB    B        B  B   B         
   B            BBB B         BB                  B  B              B         B       B    B      B  
   BB       B BB   B     B     B  B            B   B B           B  B B    B  B     BB   B           
B                 B   B                   B                   B       B        B B B              B  
  B B    B  B          B   B          B B B       BB B    B      B               B B  B  B         B 
               B      B B   BB  B   B  BBB     B     B BB        B    B       B      B B   B B       
    B                 B   B    B   BBB       B B       B  B       B        B    B         B BB      B
   B B    BB  B    B B   BB         B     B     B BBB   B   B     B  B  B   BB B        B            
  B   BB  B  B     B  B  B B  B      B      B     BB      B        B B B  B     BB BB     BB   B     
              B B  B  BB                            B     B          B  B       B            B BB    
          B B B  B   BB  B B B    B         B        B   B    B B       BBB   B    BBB  B     B      
    B BBB   B  B   B   BB    B     B     BBB     B     B       B   BB     B  B        BB      B      
  B     BB        B B   B B                 BB     B        B BB               B B B         B    BB 
  B B    B          B      BBB    B      B     B      B B B               B             B     B    B 
                        BBB                       B BB      B   B      B   BB  B     BB    B   BB    
         BB              B                               B       B      B   B      B                B
 B     B     B   B     B   BB  B B        B          B  B                 BB B         B          B  
B  B  B BB   B   B   BB  B         BB B  BBB B  B  BB   B  B      B            B BB BBB       B   B  
       B B  B         B  BB              B   B      B      B          B  B    B     B             B  
 B   B B B  B B  B    B    BB     B    B     B BB  B  B         B    B   BBB B       BB         B    
B    B                  BB    B        B        B B      B B        B     B      B   B      B B      
  B    BB  B B    B BB BB       BB   B   BB BBB            B B               BB B  B BB  BB BB  T    
          B B             B    BB  BB B   B  B   BBB  B    B    B        B     BBB  B B    B   BB    
  B  B BB    B     B       B             B    B   B         B B     B    B        B                  
B B       B                   B    B        B B     B                                   B     B      
       BBB   B B BB    B     BB   B         B         B B B B   B   BB     B              B       B  
     B        BB   B             B  B         B       B          B   B BB  B  B     BB               
 B            B   B     B                            BB             B      B  B       B   B          
     B    B  BBB     B           B B B   B      B BB    BB BB    B                       BBB B B    B
  B           B  B  B                B      B B  B  B  B     B      BB    B           B     BB B B BB
 B   B B  BB    B B   B BB     B BB    BB    B  B    BB    B     B B B      B       B   BB   B  B  B 
  B B         B  B     BB B  B B B B B     BB         BB      B    B B           B  B    B B B   B   
B BB       B     B      B  B B    B       B   B      B    B          B  BBB  B      B  B BB          